18
1,5,6,3,6,1,5,7,5,7,5,7,5,5,5,5,7,6
3,5,12,10,11,7,5,15,4,9,4,11,5,7,5,5,14,10
10,2,3,14,10,11,7,12,1,7,4,10,3,15,5,4,8,10
10,11,14,10,8,10,9,5,7,13,4,10,10,11,7,4,2,10
11,14,8,9,5,13,7,6,11,4,3,14,11,14,11,6,11,14
10,11,6,2,3,7,14,11,13,5,14,10,10,11,14,11,14,10
10,11,13,15,12,10,10,10,3,6,10,10,8,10,10,8,10,10
10,10,3,12,3,12,9,14,8,9,14,10,2,10,9,6,10,10
10,8,10,2,10,1,5,14,3,6,10,11,15,12,1,12,10,8
11,4,10,10,10,1,5,14,9,14,10,10,11,7,7,5,13,4
9,6,11,15,14,3,5,15,5,13,13,14,10,8,11,5,5,4
3,14,10,10,11,14,3,13,5,5,4,10,11,6,11,4,3,6
10,10,8,8,8,11,13,7,5,5,7,14,8,10,11,5,12,10
10,10,3,5,4,9,5,13,6,2,10,9,5,15,13,4,1,14
10,10,11,7,7,5,5,5,13,15,15,7,5,13,5,4,1,14
11,15,14,9,13,5,5,5,4,10,10,9,7,5,5,4,2,10
10,10,11,7,5,7,4,3,4,10,10,3,12,1,7,5,15,12
8,8,8,9,4,9,5,13,4,8,8,9,5,5,13,4,9,4
