18
1,5,5,7,6,2,2,2,1,7,5,5,7,5,4,2,2,2
2,3,5,12,11,15,12,10,1,15,4,1,15,7,4,10,10,10
11,13,7,5,14,11,5,13,5,15,4,3,14,11,6,10,11,14
10,2,11,6,10,11,5,7,4,9,6,10,10,11,14,11,14,10
8,11,12,10,10,10,3,13,6,1,13,14,10,10,9,12,8,10
2,10,1,14,10,10,11,4,10,3,5,13,15,14,3,5,5,14
9,14,3,12,10,10,9,6,8,9,7,4,10,10,11,5,5,14
3,12,11,5,14,11,7,15,5,5,15,4,11,12,10,2,2,10
11,6,11,6,10,10,10,10,3,6,9,5,14,3,14,11,14,10
10,9,14,8,11,14,10,11,13,12,3,5,12,8,10,10,10,10
10,1,15,5,12,9,14,9,7,5,13,5,4,1,12,10,9,12
9,7,13,5,7,4,11,7,13,5,5,5,7,4,3,13,7,4
1,13,5,5,15,6,10,9,5,7,5,6,10,2,9,4,11,4
2,1,5,6,10,10,11,7,7,15,6,10,11,15,5,7,13,4
10,3,5,13,15,13,12,8,10,8,8,11,12,8,1,13,5,6
10,10,3,4,11,5,5,5,13,6,2,11,7,5,5,5,7,12
11,15,13,5,13,4,1,5,5,13,14,8,11,5,5,5,15,4
9,13,5,5,5,5,5,5,5,5,13,5,13,5,5,5,13,4
