18
1,5,7,5,5,5,7,5,6,2,3,4,1,5,7,5,5,4
3,5,13,5,5,5,15,5,12,10,9,6,3,5,13,5,7,4
11,7,7,7,5,7,13,5,4,11,7,12,11,6,1,5,14,2
10,10,8,9,5,15,4,1,6,8,11,4,8,11,7,5,12,10
10,10,2,2,2,10,2,1,15,7,13,5,5,12,11,5,5,14
10,11,14,10,10,11,15,7,13,13,7,5,5,7,14,1,5,14
11,14,11,15,15,14,10,9,5,5,13,7,6,10,11,7,5,12
10,10,10,10,8,10,8,3,5,5,7,14,10,10,10,10,1,6
10,10,10,9,6,9,6,10,3,7,14,10,10,11,14,10,3,14
11,14,10,1,14,3,13,14,9,12,10,10,11,14,10,10,10,8
10,10,10,1,15,13,4,8,3,7,14,10,8,10,9,13,15,4
10,10,11,5,13,5,7,5,14,10,10,11,5,14,2,3,12,2
10,9,13,7,7,7,13,6,8,10,10,11,6,10,10,11,4,10
11,7,5,12,8,8,1,12,3,15,14,8,9,13,15,13,6,10
10,10,3,4,2,2,2,2,11,14,11,6,3,5,12,1,15,12
10,9,13,6,11,14,11,15,14,10,8,11,13,5,4,1,14,2
10,2,2,11,14,8,8,8,10,11,5,13,7,5,5,5,14,10
8,9,13,12,9,5,5,5,12,9,5,5,13,5,4,1,13,12
