18
1,5,7,5,6,2,3,5,5,4,2,2,2,3,6,2,3,6
3,7,13,4,8,10,10,3,5,6,10,11,13,12,11,13,12,10
11,15,6,3,5,14,10,10,3,14,11,12,3,5,13,5,6,10
10,10,10,11,4,11,15,14,10,8,10,1,15,4,3,7,14,10
10,10,11,13,4,10,8,8,9,7,12,1,13,5,14,8,10,10
10,11,15,5,5,13,7,4,2,9,7,6,2,1,14,1,15,14
10,10,11,5,5,6,10,3,15,5,14,10,11,7,15,5,15,12
9,12,11,5,4,11,15,14,8,1,14,10,10,10,10,2,11,6
1,5,13,5,6,8,8,11,7,6,11,14,10,11,15,15,14,10
1,5,5,5,14,2,2,10,9,12,10,11,14,10,10,10,11,14
2,2,3,6,10,10,10,10,3,6,10,10,10,10,8,8,10,10
9,15,12,10,10,11,14,10,10,11,14,10,10,10,1,7,12,10
3,13,6,9,15,14,10,10,11,14,11,14,9,14,1,13,4,10
10,1,14,3,12,8,11,12,10,10,10,10,3,13,5,5,5,14
10,1,14,9,6,1,15,5,12,10,10,10,9,5,7,5,5,12
10,3,13,7,15,6,9,7,4,9,12,9,5,7,13,5,5,4
11,15,5,12,8,9,7,13,5,7,5,5,4,9,7,5,5,4
8,9,5,5,5,5,13,5,5,13,5,5,5,5,13,5,5,4
