18
1,7,7,5,5,4,3,5,5,5,6,2,2,2,3,5,5,6
2,11,15,7,7,6,9,5,7,4,11,15,15,15,12,1,5,12
11,12,10,10,10,9,5,5,15,4,10,8,11,15,5,5,5,4
11,6,11,14,10,3,5,7,13,4,9,6,11,13,7,7,6,2
10,10,10,10,9,14,1,13,5,5,5,13,13,4,10,10,9,14
8,10,10,11,7,14,3,7,5,5,5,5,7,6,11,14,3,12
1,14,10,10,8,9,12,9,7,5,5,5,15,15,14,10,11,4
3,12,11,12,3,7,6,3,13,5,7,7,12,10,10,11,15,4
11,5,14,3,14,10,10,11,7,6,10,9,4,8,8,8,11,4
10,2,11,12,10,10,10,10,9,12,9,5,5,7,4,2,11,6
10,10,11,4,8,8,11,13,7,5,5,5,5,13,7,13,14,10
10,10,11,5,5,7,12,2,9,5,6,3,5,5,13,5,12,10
10,10,10,2,1,15,4,11,7,7,13,13,5,5,7,5,5,14
9,13,15,12,1,13,4,8,11,13,6,1,6,2,10,2,2,10
3,5,12,2,3,6,3,4,11,7,14,1,15,14,10,10,10,10
11,5,4,11,14,9,13,7,12,8,11,5,12,10,11,14,10,10
9,5,5,12,11,7,5,13,5,5,15,7,5,14,10,10,10,10
1,5,5,5,13,12,1,5,5,5,13,13,5,13,12,9,13,12
