18
1,7,5,4,3,5,5,7,6,2,2,2,2,1,7,5,6,2
1,13,7,5,15,4,2,10,10,10,11,14,10,3,13,4,11,12
1,5,15,4,9,5,13,14,9,12,10,10,10,10,2,3,15,4
1,5,13,7,5,6,1,15,5,5,12,10,11,15,15,14,9,6
1,5,7,14,1,14,2,11,5,5,7,15,14,10,10,10,3,14
2,2,10,10,1,15,15,13,4,1,14,8,11,12,8,10,8,8
11,13,12,10,3,12,9,5,5,5,14,3,12,2,2,11,4,2
11,6,2,11,13,6,3,7,5,5,14,11,5,15,13,13,5,14
10,9,12,10,1,12,8,9,7,6,10,10,3,15,7,5,5,14
11,7,7,15,5,5,5,4,9,12,11,13,12,8,9,5,6,10
10,10,9,14,2,1,5,7,5,5,15,5,5,5,7,5,12,10
10,10,1,15,14,3,7,12,1,7,13,7,7,5,13,5,4,10
8,10,1,12,9,12,10,2,1,15,6,9,15,5,5,5,7,12
2,11,6,2,2,2,11,13,7,12,10,3,12,1,7,4,11,6
11,12,9,13,15,13,14,3,15,5,15,15,4,3,15,6,10,10
10,1,7,5,13,6,10,10,11,4,10,11,5,14,10,11,14,10
10,3,15,4,1,14,8,8,9,6,10,9,6,10,8,8,10,10
9,12,9,5,5,13,5,5,5,12,9,5,12,9,5,4,8,8
