18
1,6,3,6,2,1,5,7,5,7,6,3,6,3,5,5,5,4
2,10,8,10,10,3,5,13,4,10,11,14,11,15,5,5,5,4
11,14,2,10,10,11,6,1,6,10,10,8,9,13,5,7,5,4
10,10,11,15,15,14,10,3,12,10,11,7,6,3,5,12,2,2
10,11,12,10,8,8,9,15,4,8,10,8,11,13,5,5,13,14
10,10,2,11,4,2,1,13,5,5,15,6,9,7,4,1,7,14
10,10,11,15,6,10,1,5,5,7,12,11,5,15,5,5,14,8
10,10,8,10,8,10,3,5,5,13,6,10,2,11,7,7,12,2
9,13,5,13,7,14,9,6,3,6,10,10,10,10,10,9,7,12
1,7,5,4,11,15,5,14,9,14,11,14,9,12,10,1,15,4
3,13,7,4,10,10,2,11,5,13,12,9,5,5,14,3,14,2
9,4,9,6,10,10,11,13,5,5,7,5,5,5,15,14,11,14
3,7,6,10,10,11,14,2,2,1,13,5,7,5,14,10,10,10
11,14,9,15,14,10,10,11,15,5,7,5,13,5,14,10,10,10
10,10,1,13,15,12,8,8,11,5,13,5,6,2,10,11,14,10
10,10,2,3,14,2,1,7,14,2,3,6,11,14,10,10,10,10
10,11,14,10,10,11,7,12,11,14,10,11,14,10,11,14,10,10
8,8,9,12,9,12,9,4,8,9,12,8,8,8,8,9,12,8
