18
1,7,7,7,4,3,7,7,7,5,5,5,4,1,5,7,5,4
3,15,15,14,2,10,9,15,13,5,5,7,6,1,5,13,6,2
10,10,10,10,11,13,7,13,5,5,5,14,11,7,5,5,13,12
10,10,10,9,15,5,12,1,5,7,4,10,11,15,4,1,5,6
10,10,10,3,13,5,5,5,5,15,6,11,14,9,6,3,4,10
11,14,10,9,7,5,5,5,5,15,14,10,10,3,13,15,5,14
10,10,11,7,13,7,5,5,5,12,8,8,10,9,4,9,6,8
11,15,14,9,7,13,5,5,5,5,6,2,11,6,2,3,12,2
10,10,10,1,13,7,5,5,7,6,10,10,10,10,11,15,5,14
10,10,10,2,3,14,2,2,9,12,10,10,10,11,14,11,4,8
11,15,15,13,12,9,14,11,5,5,13,15,12,10,8,11,5,4
10,10,11,5,5,4,10,10,1,7,5,13,7,12,1,13,6,2
10,10,10,2,2,2,10,11,7,15,5,5,13,6,3,7,12,10
10,10,10,10,11,12,11,14,10,11,5,5,5,15,12,9,5,14
10,10,9,13,15,5,12,10,10,10,2,1,7,14,2,2,3,12
10,10,1,5,13,7,4,10,10,10,11,5,12,8,10,11,15,4
11,14,3,5,5,13,4,10,11,14,9,5,7,5,13,14,9,6
8,9,13,5,5,5,5,12,8,8,1,5,13,5,5,13,5,12
