18
1,7,5,6,1,7,5,7,6,3,7,7,5,5,5,7,5,4
3,15,6,11,5,15,6,10,10,10,8,10,3,5,5,15,5,4
10,10,10,8,3,12,11,14,10,9,4,10,11,7,5,13,5,4
10,10,10,3,14,2,10,10,11,5,5,13,13,13,5,7,5,4
11,12,10,10,10,11,14,11,13,6,3,7,5,5,7,14,2,2
10,2,11,14,11,14,10,8,1,15,12,8,3,5,14,9,15,12
10,11,14,11,14,10,11,7,5,13,5,4,10,3,14,3,13,4
11,12,10,10,11,14,10,11,5,5,7,7,14,10,10,11,7,6
11,4,11,14,10,10,9,14,3,7,14,10,11,12,11,14,10,10
9,6,8,11,14,11,4,10,9,12,10,10,10,2,10,10,10,10
1,15,4,10,10,11,4,11,7,6,10,10,10,10,11,13,14,10
2,11,7,14,9,15,5,14,10,11,14,11,14,10,10,2,11,14
11,12,10,10,3,13,4,8,11,14,10,10,10,9,13,14,8,8
11,4,10,10,9,7,4,2,10,11,15,12,10,1,5,15,5,4
11,4,11,14,3,15,6,11,14,10,11,6,11,5,7,13,5,4
11,6,10,10,10,8,8,8,8,10,10,11,13,5,13,5,7,6
8,10,8,10,11,5,7,5,7,13,12,11,7,5,7,6,11,12
1,13,5,13,13,5,13,5,13,5,4,8,9,4,8,9,13,4
