18
1,5,6,1,7,5,5,6,2,3,7,6,3,7,6,3,4,2
2,3,15,7,13,5,4,10,10,10,8,9,14,8,9,13,5,14
11,14,8,9,5,7,4,10,10,9,5,5,15,4,2,2,1,14
8,11,4,1,7,13,4,11,14,3,5,7,13,5,15,13,5,12
1,15,5,7,14,3,4,10,9,13,5,13,5,5,13,5,5,6
3,13,4,10,9,13,5,15,6,3,5,4,3,5,7,5,5,12
11,5,7,13,5,7,5,14,9,13,7,6,11,5,13,7,5,4
9,7,13,5,7,13,4,8,1,5,14,10,11,5,5,13,5,6
1,15,7,5,13,5,5,6,3,6,10,10,9,5,7,7,7,14
3,12,11,5,5,7,6,10,11,12,11,13,5,7,13,14,10,10
9,6,9,7,6,10,9,13,15,5,12,1,6,11,6,10,10,10
3,12,3,14,10,11,5,5,15,5,6,3,12,10,8,11,14,8
11,6,11,14,11,14,2,1,14,3,13,13,5,13,6,10,10,2
10,10,10,10,10,11,14,3,12,10,2,3,5,5,12,8,11,14
10,11,14,11,14,8,10,10,2,10,10,11,5,7,6,3,13,12
10,10,10,10,9,7,12,10,10,10,11,14,1,14,11,15,5,4
11,14,10,9,5,13,7,13,15,13,12,8,1,12,10,9,5,6
8,8,9,5,5,5,13,5,13,5,5,4,1,5,13,5,5,12
