18
1,5,7,4,3,7,5,5,5,5,7,6,3,5,5,5,5,6
3,5,13,5,15,15,7,6,1,7,14,9,13,5,7,5,5,14
9,5,7,4,10,10,8,11,5,13,13,5,5,5,15,5,4,10
3,4,9,6,10,11,5,13,5,5,7,5,4,3,13,5,6,10
9,6,1,14,9,15,5,5,7,5,15,5,5,13,6,3,12,10
3,12,1,15,5,13,5,7,15,6,11,7,4,3,12,9,4,10
9,7,5,13,5,5,5,12,10,11,12,9,5,12,1,7,4,10
2,11,6,2,2,3,5,7,13,13,6,3,7,4,1,15,5,14
9,12,10,10,10,10,3,14,3,6,10,10,9,6,2,10,2,10
1,7,14,9,15,12,10,8,9,13,15,13,5,14,10,11,15,14
3,14,11,7,13,4,9,7,6,2,9,6,3,13,14,11,14,10
10,11,14,10,2,2,2,10,11,13,5,12,11,5,15,14,10,10
11,14,9,14,10,10,11,15,15,6,2,2,9,6,10,10,10,10
10,10,2,10,9,15,12,8,10,10,10,9,7,12,11,12,11,12
10,10,9,14,1,15,5,4,10,10,10,1,13,5,14,3,14,2
10,10,1,15,7,13,5,4,10,11,13,5,5,7,12,10,10,10
10,11,5,13,15,7,5,4,11,15,5,5,5,13,6,10,9,12
9,12,1,5,13,13,5,4,8,9,5,5,5,5,13,13,5,4
