18
1,7,5,5,5,5,7,7,5,5,7,5,4,3,7,5,5,4
1,14,3,7,7,5,13,13,5,5,15,7,5,14,9,5,5,4
3,13,12,11,13,6,1,7,7,5,12,11,5,13,6,2,3,6
11,4,3,13,6,11,7,12,10,1,7,13,5,6,9,15,14,10
11,6,10,1,14,8,9,4,9,5,15,5,4,10,3,12,10,10
8,8,10,1,13,7,7,5,7,4,11,7,6,11,15,4,11,14
3,6,10,2,1,14,10,3,13,4,10,10,10,10,9,6,10,10
10,10,10,11,5,12,10,11,5,5,14,11,14,10,2,9,14,10
10,10,11,15,6,2,10,10,3,6,8,10,10,9,15,5,13,12
10,9,12,8,9,14,10,11,13,12,2,10,10,2,11,7,6,2
9,5,5,7,5,13,14,11,5,5,13,14,9,15,12,8,10,10
2,3,7,13,5,5,12,9,5,5,7,13,6,10,3,5,12,10
11,15,15,7,7,7,4,2,2,2,10,2,10,10,9,5,5,12
10,10,10,10,10,11,5,15,14,10,10,10,10,10,3,5,5,4
11,14,10,10,10,10,2,10,10,11,15,14,10,10,9,5,5,6
10,10,10,11,14,11,13,12,9,14,8,11,14,11,6,3,7,14
10,10,11,14,10,11,7,5,5,13,4,10,11,14,10,10,10,10
8,9,12,8,9,12,9,5,5,5,5,13,12,8,9,12,8,8
