18
1,6,2,3,6,3,7,5,5,7,5,4,3,6,3,7,6,2
2,10,11,15,14,10,10,3,5,15,5,5,12,10,10,10,10,10
11,13,12,8,11,14,10,10,3,13,7,5,6,9,12,8,11,12
11,6,3,6,10,8,10,10,10,1,13,6,10,3,5,4,10,2
10,11,14,10,11,6,10,11,14,1,5,15,14,11,6,2,11,14
10,10,11,14,10,11,14,11,14,3,6,10,11,12,11,12,8,10
10,10,10,9,14,11,13,14,10,10,9,14,10,3,13,5,5,12
11,14,10,2,10,11,4,10,9,13,4,8,9,15,5,5,4,2
10,11,14,9,14,9,6,10,3,7,6,1,6,9,5,7,4,10
10,8,8,1,14,1,15,14,9,12,11,7,15,5,7,13,4,10
11,5,5,5,12,3,12,9,6,2,10,10,8,1,15,5,4,10
10,3,5,5,6,11,4,2,11,15,14,9,5,5,13,5,5,14
11,15,7,4,10,9,6,10,10,10,9,7,5,5,5,7,4,10
10,10,11,4,9,7,12,11,12,9,5,13,5,7,5,13,4,10
8,11,15,5,4,9,5,15,4,1,5,7,5,13,6,3,6,10
1,14,11,6,1,7,5,15,5,5,5,13,7,5,13,12,11,14
3,12,8,11,7,13,5,13,5,5,5,6,11,5,5,7,13,12
9,4,1,12,9,5,5,5,5,5,5,13,12,1,5,13,5,4
