18
1,7,5,5,7,5,5,7,5,6,2,2,1,7,5,5,5,6
1,14,3,5,13,4,3,15,6,11,13,15,7,13,5,5,7,12
1,14,10,3,5,6,10,10,11,14,3,12,9,5,5,7,13,6
3,12,10,10,3,14,10,10,10,10,11,5,5,5,5,13,6,10
11,5,14,11,14,9,14,11,14,10,11,5,5,5,7,5,13,12
11,4,9,12,11,6,10,10,10,10,11,7,4,3,13,6,1,6
11,5,5,4,8,11,13,12,11,13,12,9,5,12,3,15,7,14
10,2,3,4,1,12,1,7,13,4,2,1,7,5,15,12,8,8
11,14,10,3,7,6,2,10,3,6,10,3,15,5,13,5,5,6
10,9,14,10,8,11,15,15,13,12,11,15,13,5,5,5,7,14
10,3,15,15,6,8,8,11,5,5,14,11,5,6,3,6,10,8
11,14,8,10,9,7,7,13,7,5,12,9,6,10,10,10,11,4
10,8,3,14,2,10,9,5,15,6,2,3,14,11,14,10,9,6
10,2,10,9,12,10,1,7,13,15,15,14,10,10,10,10,1,14
11,14,11,5,4,8,1,15,4,10,10,10,10,10,11,15,7,12
10,11,15,5,5,6,1,15,4,10,8,10,11,15,12,10,11,4
10,8,9,5,6,10,1,13,6,9,6,11,14,10,1,14,9,4
8,1,5,5,12,9,5,5,12,1,13,12,8,9,5,13,5,4
