18
1,7,6,2,2,3,4,3,4,3,7,4,3,5,5,7,4,2
1,14,11,14,11,13,5,13,6,10,9,6,10,2,2,11,4,10
3,12,8,11,14,1,5,6,11,14,1,14,10,10,11,14,3,14
11,4,2,10,10,3,5,13,14,8,1,15,12,9,12,9,14,10
9,7,12,8,10,8,2,3,13,5,5,15,7,5,5,5,12,10
1,14,1,5,15,4,10,10,2,3,5,15,13,5,7,5,6,10
3,12,1,5,15,5,15,15,12,10,3,13,7,5,13,4,10,10
9,7,5,7,13,4,10,11,7,12,11,5,13,7,5,4,10,10
3,13,5,13,5,6,10,10,11,6,9,7,5,15,5,6,10,10
9,5,7,7,7,13,13,12,9,12,1,15,7,14,1,13,13,14
1,5,12,11,15,7,7,5,5,5,7,12,10,11,6,2,3,12
3,5,5,12,10,10,9,6,1,7,13,4,10,8,9,13,15,4
10,2,2,2,10,10,3,15,5,13,5,5,14,3,7,4,11,4
11,15,14,10,10,10,11,12,3,5,5,7,12,8,11,6,11,4
10,10,10,10,10,10,9,7,15,6,3,14,1,6,10,8,11,4
10,10,11,13,12,10,1,14,10,11,14,10,1,15,13,6,11,4
11,14,11,5,5,13,5,14,8,8,8,10,3,12,3,13,13,6
8,9,13,5,5,5,5,13,5,5,5,13,13,4,9,5,5,12
