12
1,7,5,5,4,1,6,3,7,7,5,6
2,10,2,3,4,2,10,10,10,10,2,10
11,14,10,9,7,14,10,8,10,10,10,10
10,10,11,6,10,9,15,5,12,8,11,12
10,10,10,9,15,5,15,6,3,7,13,4
10,10,10,3,14,3,14,11,15,14,3,4
10,10,11,14,8,9,12,10,10,11,15,6
11,13,12,10,2,3,7,12,10,10,10,10
10,2,2,9,13,14,9,5,14,10,10,10
9,15,12,3,5,13,5,4,10,10,10,10
1,13,7,13,5,7,7,7,15,15,12,10
1,5,13,5,5,12,8,8,8,9,5,12
