12
1,6,2,2,2,1,7,6,2,1,7,6
3,12,11,14,11,6,10,10,11,6,10,10
11,5,12,10,10,9,14,9,12,11,12,8
10,2,2,9,12,1,13,7,5,15,7,4
10,10,10,3,7,5,5,15,6,10,9,6
10,11,12,10,10,3,6,8,10,8,3,14
11,13,7,14,8,9,13,5,13,6,8,10
10,2,11,13,7,5,5,5,7,13,5,14
11,13,13,6,11,5,5,5,15,4,1,14
10,3,5,15,14,3,5,7,13,7,5,12
10,11,4,8,10,11,7,13,5,13,7,4
8,9,5,4,8,8,8,1,5,5,13,4
