12
1,7,5,6,1,7,5,5,5,5,5,6
3,14,3,12,3,13,7,5,5,4,2,10
10,10,9,5,15,5,13,5,5,6,10,10
8,9,5,7,13,5,5,7,5,12,10,10
3,5,5,12,3,5,5,13,7,4,11,12
9,5,5,7,14,3,6,1,13,5,15,4
3,7,7,14,10,11,12,3,6,3,12,2
10,10,9,14,9,13,7,12,8,9,7,12
10,11,4,10,3,7,14,2,3,5,13,6
10,11,4,10,10,10,11,15,14,3,5,12
10,11,6,10,10,10,8,10,8,9,5,6
8,8,8,9,12,9,5,13,5,5,5,12
