12
1,6,2,3,5,7,6,2,3,6,1,6
3,13,13,12,1,12,9,13,12,11,7,12
11,4,3,5,5,5,5,7,5,12,9,6
9,5,13,7,5,5,5,12,2,2,1,14
1,5,5,15,5,5,5,7,14,10,1,14
1,7,5,12,2,3,6,8,11,15,5,14
3,15,7,5,12,9,14,2,10,10,2,10
11,14,11,6,1,5,13,15,12,11,14,10
10,10,10,9,5,5,5,15,7,13,12,10
10,10,11,5,5,5,4,11,15,7,4,10
10,10,9,5,5,7,5,14,10,11,5,14
8,9,5,5,5,13,4,8,8,9,4,8
