12
1,5,6,3,6,2,1,7,7,4,2,2
3,6,11,14,8,10,1,14,11,6,10,10
8,11,12,9,4,10,3,12,8,9,15,12
1,13,7,5,4,11,14,2,2,3,14,2
3,5,13,4,3,12,9,15,15,14,11,14
11,5,5,5,13,7,6,10,10,10,10,10
11,5,5,6,2,9,12,10,8,10,10,10
10,2,3,13,15,5,5,13,4,11,15,14
10,10,9,6,9,5,5,5,7,14,8,8
11,14,1,14,1,5,7,5,13,15,4,2
10,10,2,10,2,3,13,5,5,15,5,12
8,9,13,12,9,13,5,5,5,13,5,4
