12
1,6,3,6,2,2,2,2,2,3,5,6
2,11,14,10,10,11,13,14,10,11,7,12
11,12,8,9,13,14,3,13,13,12,9,6
11,7,4,2,3,14,11,6,2,2,1,14
10,11,4,11,14,8,8,10,10,10,3,12
10,9,6,10,8,3,6,9,15,12,11,6
10,2,11,15,5,13,12,3,13,5,12,10
10,9,14,9,5,5,7,12,2,2,3,14
10,2,10,1,5,5,13,7,15,15,12,10
11,15,15,5,5,5,7,12,10,11,4,8
10,10,9,5,5,7,13,6,10,10,1,6
8,9,5,5,5,13,5,12,8,9,5,12
