12
1,7,5,5,5,5,5,5,7,4,2,2
3,15,6,1,6,3,5,5,13,7,13,12
10,11,14,1,15,14,3,5,7,13,5,4
10,10,10,1,14,9,13,5,15,5,5,6
10,10,11,7,12,1,5,6,10,1,7,14
10,10,11,15,6,3,6,10,10,3,12,10
9,14,8,10,11,13,12,10,10,11,4,10
1,14,2,10,10,2,2,11,14,9,6,10
1,13,14,10,10,10,10,8,9,5,15,14
3,7,15,15,14,10,11,6,2,3,12,10
8,10,8,8,8,11,14,9,15,13,5,14
1,13,5,5,5,12,8,1,13,5,4,8
