12
1,7,7,6,3,5,6,2,2,3,7,6
3,14,10,11,13,6,11,13,13,12,10,8
10,8,10,10,3,12,11,5,5,5,15,6
9,6,11,14,9,5,15,4,2,3,14,10
1,14,10,10,3,5,13,6,10,10,10,10
3,14,10,9,14,3,6,10,11,14,11,14
10,11,14,1,14,11,12,11,12,8,10,10
10,10,9,5,13,13,7,13,5,4,8,8
11,13,5,5,7,5,13,5,5,7,6,2
10,1,5,5,13,7,5,7,7,15,14,10
10,1,5,7,5,12,1,12,8,8,10,10
8,1,5,13,5,4,1,5,5,5,13,12
