12
1,7,6,3,5,5,5,5,5,7,5,6
2,10,11,14,3,5,5,4,3,14,2,10
11,12,8,8,10,2,3,7,14,10,10,10
11,5,5,5,15,13,12,8,11,14,10,10
9,5,5,6,11,5,5,6,8,11,14,10
1,5,5,14,9,7,6,11,6,10,11,14
3,5,5,13,6,9,12,10,10,10,10,10
11,4,1,5,15,5,7,14,10,11,14,10
11,5,5,5,15,4,8,10,8,10,10,10
10,2,3,5,13,7,7,13,4,10,10,10
10,11,13,6,1,14,9,5,5,12,11,14
9,12,1,12,1,12,1,5,5,5,13,12
