12
1,7,5,5,5,7,4,2,3,7,6,2
3,13,5,5,5,15,5,14,10,10,9,14
11,5,4,3,5,14,2,10,10,10,1,14
9,7,5,13,4,11,12,10,10,10,1,12
1,15,5,5,5,13,4,10,10,11,7,4
1,15,5,5,5,7,6,10,10,10,9,4
3,13,7,5,4,9,12,10,10,11,5,6
10,1,15,5,5,5,4,10,10,10,1,14
10,3,12,3,5,5,5,13,15,14,3,14
10,10,2,10,2,3,7,5,13,14,8,8
10,9,13,15,15,12,9,7,5,13,6,2
9,5,4,8,8,1,5,13,5,4,9,12
