12
1,5,5,7,5,4,3,5,6,1,7,4
1,5,5,13,7,5,12,3,13,7,13,4
3,7,5,7,13,5,5,15,4,11,5,4
10,11,6,11,7,7,5,14,2,9,7,4
10,8,10,10,10,8,1,14,9,5,13,6
11,5,14,10,10,3,6,10,1,6,3,14
10,3,15,14,10,9,14,10,1,14,10,8
10,10,10,11,14,3,15,15,5,13,13,4
10,10,11,14,9,14,9,13,7,5,5,4
10,10,10,8,1,15,5,5,13,7,5,4
10,11,14,2,1,15,5,5,6,11,6,2
8,8,9,13,5,13,5,4,9,12,9,12
