12
1,7,7,5,6,1,5,7,5,5,5,6
2,10,10,2,11,7,5,13,5,5,4,10
10,10,10,11,15,13,5,5,5,5,5,12
10,10,10,9,15,5,5,5,6,2,2,2
9,14,9,5,13,5,5,7,12,11,14,10
3,15,5,5,7,7,6,9,6,10,11,14
10,10,3,5,12,9,12,3,13,14,8,8
10,10,10,2,2,1,7,14,1,13,7,4
11,15,14,9,14,3,14,10,1,5,15,4
10,10,10,3,14,10,8,10,3,7,13,6
10,8,11,12,8,11,6,10,10,10,3,12
8,1,13,5,5,12,8,9,12,8,9,4
