12
1,6,1,7,5,5,5,7,7,5,5,4
1,13,5,13,6,1,7,12,9,7,5,4
2,3,7,5,15,5,13,4,3,13,5,6
10,8,10,1,15,5,7,6,10,1,6,10
10,3,14,1,14,1,14,10,11,7,14,10
11,14,10,3,14,3,14,11,14,11,15,14
8,8,9,12,10,9,12,11,12,10,10,10
1,5,5,7,13,5,5,15,4,10,8,10
3,5,5,13,4,3,5,13,4,10,2,10
11,5,5,5,6,11,5,5,4,11,14,10
10,3,5,7,13,13,7,5,5,14,9,14
8,8,1,13,4,1,13,5,5,13,5,12
