12
1,5,7,5,5,5,5,5,7,5,7,6
1,7,13,5,7,4,3,7,13,7,12,10
3,13,5,5,15,5,14,10,3,13,6,10
10,2,2,1,13,4,8,10,11,5,14,10
10,11,14,3,7,5,5,14,11,4,10,10
11,14,11,14,10,3,6,9,13,6,10,10
10,10,10,10,11,13,12,1,7,12,10,10
10,11,14,10,9,5,7,5,13,6,8,10
10,10,10,8,3,5,13,5,7,13,4,10
10,10,11,5,15,5,4,1,13,5,7,14
11,14,8,1,15,5,5,7,6,2,10,10
8,9,5,5,13,5,4,8,9,13,12,8
