12
1,6,1,7,5,5,7,5,5,5,5,6
2,10,3,15,5,5,13,4,3,5,5,14
11,14,11,13,5,7,5,4,11,6,2,10
10,11,14,2,1,15,5,4,10,11,14,10
8,10,9,13,5,13,5,6,10,8,10,10
1,13,5,7,4,3,6,11,14,3,12,10
2,2,2,11,7,13,12,11,15,15,6,10
11,15,15,12,9,5,5,14,10,10,10,10
10,8,9,5,7,7,5,12,10,10,10,10
9,5,7,5,13,13,5,4,8,10,10,10
3,4,9,7,5,5,5,5,7,14,10,10
9,5,5,13,5,5,5,5,12,9,13,12
