12
1,7,6,3,4,3,6,1,5,5,7,4
2,10,11,14,2,10,11,5,5,5,15,4
11,12,10,11,14,10,10,1,7,5,13,4
10,1,14,10,9,12,9,7,13,6,3,6
10,1,12,9,5,5,5,13,5,13,14,10
11,5,5,5,4,3,6,1,7,5,14,10
9,7,5,5,5,13,12,3,14,3,12,10
1,14,2,1,5,6,3,14,10,10,2,10
3,13,13,5,5,14,10,10,11,14,11,14
10,3,5,5,5,15,14,10,10,11,12,10
10,10,1,7,5,12,8,10,8,9,6,10
9,13,5,13,5,5,5,13,5,5,12,8
