12
1,7,6,1,7,5,5,5,7,5,6,2
3,14,11,7,13,7,5,5,13,6,10,10
8,10,8,9,5,13,5,5,4,11,15,14
1,15,7,7,7,5,5,5,5,14,10,10
1,14,8,10,11,5,5,6,2,11,15,14
1,13,7,14,10,3,6,9,15,12,10,10
2,1,15,14,10,11,12,3,13,4,10,10
11,5,14,10,8,10,3,13,5,6,8,8
10,1,12,10,3,13,15,5,5,13,7,4
9,5,4,11,12,3,14,3,5,7,13,4
2,2,3,13,6,8,9,14,1,13,5,6
9,13,12,1,13,5,5,13,5,5,5,12
