12
1,7,5,7,4,1,7,6,3,7,7,6
1,14,3,13,5,6,10,11,14,8,8,8
1,14,9,7,4,10,10,8,9,5,5,6
3,13,5,15,4,9,13,6,2,2,3,14
11,4,2,10,2,1,5,15,15,14,10,10
11,6,11,14,10,3,6,10,10,11,12,10
8,9,12,9,15,13,12,10,10,10,3,12
1,5,5,7,13,5,5,12,8,10,9,4
2,3,7,13,5,5,5,5,7,15,5,6
9,12,11,5,5,5,7,7,12,8,3,12
2,3,14,2,3,5,13,13,7,4,10,2
9,12,9,13,13,5,5,5,13,4,9,12
