12
1,6,2,2,2,3,7,5,7,5,5,4
1,15,14,10,10,10,9,5,13,7,4,2
2,10,10,10,10,10,2,2,2,9,7,14
10,10,10,11,15,14,11,13,14,3,12,8
10,10,11,12,8,9,14,3,12,9,7,4
10,11,13,7,4,3,14,11,7,5,15,6
11,14,1,13,6,9,12,10,10,1,12,10
10,11,5,5,15,5,5,14,10,2,2,10
10,10,2,1,15,5,5,14,10,10,10,10
10,10,10,1,15,5,4,10,10,10,10,10
11,13,13,5,13,5,6,11,14,10,10,10
9,5,4,1,5,5,12,9,13,13,13,12
