12
1,7,5,6,2,3,7,7,5,5,5,4
1,15,4,10,10,10,10,9,5,6,2,2
3,13,4,9,12,8,11,5,5,13,13,12
9,5,6,3,7,7,13,5,5,5,7,6
3,5,13,13,14,9,5,5,6,3,13,14
9,5,5,6,10,3,6,1,13,13,6,10
3,5,7,14,11,13,12,1,7,5,12,10
10,1,15,14,10,3,5,7,13,5,4,10
10,1,14,10,11,13,7,15,5,5,4,8
10,1,14,10,10,3,13,15,5,5,5,4
10,1,14,10,10,11,7,13,5,5,5,6
9,5,12,8,8,9,13,5,5,5,5,12
