12
1,7,5,5,7,5,5,7,5,5,7,6
3,13,5,7,15,5,6,9,7,4,10,8
11,4,1,12,9,6,10,1,15,4,11,4
11,5,5,7,5,12,11,5,13,4,9,6
10,2,3,15,5,4,8,2,3,5,7,12
8,9,12,11,4,3,6,10,10,2,9,6
3,5,5,13,4,9,13,14,10,10,3,14
11,6,3,7,7,5,6,10,11,15,14,10
10,11,14,10,9,6,9,13,12,10,11,14
10,10,8,11,5,13,5,7,4,10,10,10
10,10,3,13,7,5,5,13,5,13,14,10
8,8,9,5,13,5,5,5,4,1,12,8
