12
1,5,7,5,5,7,7,5,6,3,5,6
3,5,13,5,5,13,15,4,10,11,4,10
11,5,4,3,5,5,13,4,10,11,4,10
10,2,2,11,7,5,5,4,9,13,6,10
9,13,15,14,11,7,5,5,6,3,12,10
1,7,12,9,14,11,6,3,14,10,2,10
1,15,4,1,12,9,12,10,10,10,10,10
2,10,3,5,5,5,5,14,10,10,10,10
10,11,15,5,7,7,7,15,14,10,11,14
11,12,8,3,12,8,10,10,11,13,12,8
11,7,7,13,5,5,12,10,11,5,5,4
8,8,9,5,5,5,5,13,13,5,5,4
