12
1,7,5,5,5,6,1,7,5,7,6,2
1,15,4,3,5,12,1,14,2,10,11,14
1,13,4,11,7,4,1,15,14,10,10,10
2,1,5,13,13,6,3,12,8,10,8,8
11,5,5,5,7,13,13,7,7,15,6,2
8,1,5,5,15,7,6,8,10,8,9,12
3,6,3,7,12,9,12,2,10,3,6,2
10,11,14,9,5,7,5,12,10,11,15,14
10,10,11,5,5,13,7,4,11,14,10,10
10,11,14,1,5,5,13,7,14,10,10,10
11,14,10,3,5,5,5,12,8,10,10,10
8,8,8,9,5,5,5,5,5,12,9,12
