12
1,5,5,5,5,7,6,2,3,5,5,4
2,3,7,5,5,13,13,15,13,5,5,6
11,14,9,5,5,7,6,9,7,5,5,12
10,10,3,5,7,14,11,5,13,5,5,6
10,10,11,4,10,8,9,7,6,3,7,14
10,10,9,6,10,3,6,8,9,12,10,10
10,11,7,12,10,11,12,1,5,7,12,10
10,10,10,3,13,13,7,7,7,14,3,14
11,14,9,12,1,7,14,8,8,9,12,10
10,10,3,5,7,13,13,5,5,5,6,8
10,11,13,5,13,5,7,5,4,1,13,6
9,13,5,5,5,5,13,5,5,5,5,12
