12
1,7,7,7,5,5,5,5,5,7,4,2
2,10,10,9,5,5,7,5,5,13,4,10
10,10,10,1,5,5,15,5,6,2,2,10
11,14,11,7,7,5,13,5,12,11,15,14
10,11,14,9,15,5,5,5,5,14,8,10
10,10,8,1,13,7,6,1,5,13,5,14
8,9,5,5,6,9,12,1,5,5,7,14
2,2,2,2,10,3,6,3,5,5,12,8
11,14,10,10,10,8,9,15,5,5,7,4
10,10,10,11,15,5,5,14,1,5,15,4
10,9,13,14,10,3,7,14,1,6,10,2
8,1,5,12,8,8,8,9,5,13,13,12
