12
1,7,5,5,5,5,6,2,2,2,3,6
1,13,5,7,5,6,11,15,14,11,14,10
3,5,5,13,5,13,14,10,11,14,10,10
11,5,5,5,5,7,12,8,8,10,8,8
10,1,6,3,7,13,5,6,2,10,2,2
9,5,13,12,10,3,6,10,10,10,9,14
1,7,5,5,12,11,12,10,10,10,3,14
1,14,1,6,3,13,5,15,15,14,10,8
1,15,5,15,13,5,4,10,8,9,13,4
1,13,7,13,7,7,6,9,5,7,5,4
1,5,14,1,12,10,10,1,5,15,5,4
1,5,13,5,4,8,8,1,5,13,5,4
