12
1,5,6,2,2,2,2,2,2,2,3,4
1,5,15,13,15,13,13,12,10,10,11,4
1,7,12,1,15,5,7,6,11,14,11,4
1,15,7,7,13,5,12,10,10,10,11,6
1,14,10,9,7,5,6,11,15,15,12,10
3,15,14,2,10,3,14,8,10,9,5,12
10,8,10,11,14,9,12,3,13,7,5,6
11,4,10,10,9,7,5,13,4,11,4,10
11,4,11,13,5,13,6,2,2,10,3,14
11,7,13,5,5,5,14,10,10,10,10,10
11,14,3,7,5,5,13,13,14,10,10,10
8,9,12,9,5,5,5,5,13,13,12,8
