12
1,6,3,6,3,5,6,2,2,2,3,6
2,11,12,11,15,6,10,11,15,14,10,10
9,14,1,12,8,10,10,10,8,9,14,10
2,11,6,3,7,12,11,14,1,5,12,10
10,10,11,14,11,4,10,11,7,6,3,14
10,8,10,8,10,3,14,8,10,9,12,10
9,7,13,4,8,9,12,2,11,5,6,10
2,9,5,5,7,6,2,10,10,2,10,10
11,7,5,5,12,9,14,10,10,9,15,12
11,13,5,7,5,4,10,11,12,1,15,4
9,5,5,15,5,4,10,10,1,7,13,4
1,5,5,13,5,4,9,12,1,13,5,4
