12
1,5,5,7,5,4,2,1,6,2,2,2
3,5,5,15,5,4,10,2,10,11,14,10
11,5,7,13,5,4,10,11,14,10,11,14
11,5,13,5,5,7,14,10,9,12,8,8
9,5,5,7,5,12,9,15,5,5,6,2
1,7,5,13,6,3,6,10,1,7,14,10
3,15,7,6,11,13,12,9,5,14,10,10
10,10,10,10,11,7,6,2,3,14,10,10
10,10,10,10,10,8,11,14,10,10,11,14
11,14,10,11,14,3,12,9,14,8,9,14
10,10,8,10,8,9,5,7,13,5,4,10
8,9,5,13,5,5,5,13,5,5,5,12
