12
1,7,7,7,5,6,3,7,7,5,7,6
3,12,10,9,4,9,14,8,8,1,12,10
9,5,13,7,5,5,13,5,7,5,5,14
3,5,5,13,5,7,5,5,15,5,5,14
9,5,5,5,7,13,5,7,14,2,2,10
3,5,5,5,14,3,6,10,11,14,10,10
10,3,5,6,11,13,12,11,14,10,10,10
10,9,6,10,11,5,5,14,10,11,14,10
10,3,14,10,10,2,2,10,10,11,14,10
11,14,10,10,10,10,10,10,8,8,11,14
11,14,10,10,10,11,14,9,5,4,10,10
8,8,9,13,13,12,8,1,5,5,12,8
