12
1,7,5,5,7,5,5,5,5,7,5,4
1,15,4,2,11,5,7,5,5,13,6,2
3,14,2,10,11,5,13,5,5,4,10,10
10,10,10,11,13,7,5,5,5,7,15,14
8,9,15,14,3,15,5,5,5,14,10,10
1,5,14,10,10,11,6,3,6,10,10,10
3,5,12,11,14,9,12,10,11,14,9,14
10,3,5,14,10,1,6,10,11,12,3,12
9,13,6,10,10,2,10,11,14,3,13,6
1,5,12,9,15,13,14,10,10,9,6,8
3,7,7,5,13,5,12,10,8,3,13,4
8,9,13,5,5,5,5,13,4,9,5,4
