12
1,7,5,5,7,4,2,1,7,5,7,6
2,9,6,2,11,5,13,5,15,4,10,10
10,1,14,11,15,7,5,5,13,5,14,10
10,2,10,10,11,13,5,5,7,5,12,8
10,10,10,10,10,1,5,5,13,5,7,4
11,13,15,14,10,3,6,3,5,5,14,2
11,5,12,8,9,13,12,9,6,1,15,12
9,5,5,7,6,2,3,6,10,3,13,4
3,5,5,12,8,10,10,11,12,10,3,4
9,7,5,5,7,15,14,10,2,10,10,2
3,13,5,6,8,8,10,11,14,9,13,14
9,5,5,13,5,5,12,8,8,1,5,12
