12
1,7,5,5,5,5,7,5,5,5,5,6
3,14,1,7,5,5,13,6,2,1,5,14
10,10,2,11,7,4,3,13,13,5,5,14
10,10,11,12,9,6,9,6,2,2,2,10
10,10,10,3,5,13,5,15,15,14,10,10
10,11,14,9,6,3,6,10,10,10,11,14
9,12,8,3,13,13,12,10,10,10,10,10
2,3,5,13,5,7,5,14,10,10,10,10
10,11,7,5,5,15,5,12,11,15,12,10
10,10,9,5,5,13,7,5,14,11,4,10
10,11,7,5,5,5,15,4,10,10,2,10
9,12,9,5,5,5,13,4,8,9,13,12
