12
1,6,3,7,5,7,6,2,2,2,3,4
2,10,8,8,3,12,10,11,15,15,15,4
10,11,5,5,13,4,10,10,8,8,10,2
10,10,2,2,3,7,15,13,7,4,11,14
11,13,13,13,12,8,8,1,13,6,10,10
10,2,3,5,6,3,6,2,2,9,14,10
11,15,14,3,13,13,12,11,12,2,10,10
10,10,10,11,5,5,5,13,6,10,10,10
10,8,9,15,5,5,5,5,15,13,15,12
11,4,3,14,1,7,6,3,12,3,13,4
11,4,10,9,5,12,11,15,6,9,7,4
9,5,13,5,5,4,8,8,9,5,13,4
