12
1,5,5,5,5,7,5,7,5,7,7,4
2,2,3,6,2,10,3,13,7,12,11,4
10,11,14,10,11,15,14,3,13,4,10,2
11,14,8,9,12,10,10,11,6,3,15,14
8,9,5,7,4,8,8,10,11,14,10,10
1,5,5,13,6,3,6,10,10,8,10,10
2,2,3,7,15,13,12,10,9,7,14,10
11,15,14,10,9,6,3,15,5,14,8,10
10,10,10,11,5,14,10,10,1,14,1,14
10,10,10,10,3,14,8,9,5,15,5,14
10,8,10,10,10,9,7,5,5,12,2,10
8,1,12,8,9,4,9,5,5,4,9,12
