12
1,6,3,6,3,6,2,3,4,3,5,6
3,13,14,10,10,10,10,9,5,14,1,12
9,6,10,11,14,10,10,1,5,14,3,6
1,12,10,8,8,10,11,5,7,13,14,10
3,6,10,3,7,13,12,1,13,4,10,8
10,9,12,10,10,3,6,1,5,7,13,4
9,5,4,8,10,11,12,2,2,9,7,4
3,7,7,7,14,11,7,12,9,7,13,4
10,8,10,8,10,10,11,7,7,14,2,2
10,1,14,2,11,12,8,10,8,9,13,14
10,3,12,10,10,1,5,14,1,5,5,12
8,9,5,12,8,1,5,13,5,5,5,4
