12
1,6,3,5,6,3,6,3,6,3,5,4
3,15,13,4,9,12,11,14,10,11,7,4
8,10,1,5,7,5,15,12,9,12,9,6
2,10,1,5,15,5,13,7,6,3,5,12
9,12,1,7,13,5,5,14,10,10,1,6
1,5,7,13,5,7,6,10,10,9,5,14
3,7,14,3,6,9,12,10,11,5,5,14
10,10,11,14,9,7,5,13,12,3,6,10
10,10,10,9,6,11,7,7,6,10,10,10
11,14,10,1,15,14,10,10,10,10,10,10
10,10,11,7,12,10,8,10,9,12,10,10
8,9,12,9,4,9,4,9,5,4,9,12
