12
1,5,5,7,5,5,5,5,7,5,5,4
1,7,5,13,5,7,5,5,13,7,5,6
1,15,5,7,7,13,5,5,7,13,4,8
1,13,7,14,11,5,5,5,13,5,7,6
1,7,14,11,15,5,5,5,7,5,12,10
3,15,14,10,10,3,6,3,14,1,6,10
10,10,10,10,11,13,12,10,11,6,10,10
11,14,10,8,9,7,5,12,10,10,10,10
10,10,11,7,5,13,5,5,14,11,15,14
10,11,14,11,7,7,7,5,13,14,10,10
10,8,8,8,8,8,8,3,5,12,11,12
9,5,5,4,1,5,5,13,5,5,13,4
