12
1,7,5,4,3,6,3,5,5,5,5,4
1,13,5,7,12,11,15,5,5,5,5,6
1,6,2,11,5,12,11,5,7,5,5,12
1,14,9,13,5,4,9,7,13,7,7,4
1,13,5,5,7,5,5,15,4,8,9,4
1,5,6,3,14,3,6,9,6,2,2,2
3,7,12,11,14,9,14,3,13,15,14,10
10,10,3,14,11,5,13,14,1,12,9,14
8,9,12,10,9,6,3,12,3,6,3,14
1,7,5,12,1,14,9,7,14,10,10,10
1,13,7,4,3,14,1,14,10,9,12,10
1,5,13,5,12,8,1,12,8,1,5,12
