12
1,5,6,3,6,2,3,5,5,5,5,6
3,7,12,10,10,10,11,7,7,4,3,12
10,11,6,10,10,10,10,8,9,4,11,4
10,10,8,10,10,10,11,5,5,5,13,4
8,9,7,15,15,13,13,7,5,5,5,4
3,5,12,8,8,3,6,11,5,5,5,4
11,5,5,6,3,13,12,9,5,5,7,4
9,7,4,11,14,2,2,1,6,3,14,2
2,10,2,10,10,11,14,3,12,10,11,14
9,13,15,14,10,10,8,9,5,14,10,10
2,3,14,10,10,9,6,3,5,14,10,10
9,12,8,9,13,5,13,13,4,8,8,8
