12
1,7,6,3,7,5,5,5,4,3,5,6
1,12,11,13,15,5,5,5,4,11,5,14
3,5,15,6,11,5,5,5,5,15,4,10
9,6,8,9,15,5,5,7,5,13,6,10
1,15,5,5,15,5,5,13,7,4,11,14
3,13,5,5,14,3,6,1,13,6,10,10
11,6,2,2,10,9,14,2,3,13,14,10
10,10,11,14,9,7,15,13,13,4,10,10
10,10,10,10,2,11,15,5,7,4,8,8
8,11,14,10,11,12,10,1,15,5,7,6
1,14,10,11,14,2,10,3,13,4,8,10
1,12,8,8,9,12,9,13,5,5,4,8
