12
1,7,5,5,6,2,2,2,2,2,3,6
2,10,3,6,10,11,15,15,13,13,12,8
10,10,10,9,14,10,10,9,7,5,5,4
11,14,10,3,15,14,10,3,13,4,3,6
10,11,14,10,10,8,9,15,5,5,12,10
10,8,8,8,9,7,6,11,5,4,3,14
11,5,5,5,4,9,12,9,7,4,8,10
9,7,5,5,5,7,5,5,13,6,1,14
3,13,5,7,5,13,5,6,3,13,6,10
11,5,5,15,5,5,7,15,13,4,9,12
11,5,7,13,5,4,10,10,1,5,5,6
9,5,13,5,5,4,9,13,5,5,5,12
