12
1,6,2,2,2,3,7,5,5,5,5,4
1,14,11,15,13,13,13,5,7,6,3,6
1,15,14,9,6,3,6,2,10,9,12,10
3,14,10,1,13,14,10,10,11,7,7,14
8,10,10,2,3,12,9,14,10,10,8,10
3,14,10,11,15,7,6,11,14,11,4,10
10,10,10,10,10,9,12,10,8,11,4,10
10,10,11,14,9,7,5,13,5,13,7,14
11,15,12,8,1,15,5,6,3,6,10,10
10,10,1,5,5,13,5,15,12,9,14,10
10,9,7,5,7,5,5,13,7,5,15,12
8,1,13,5,13,5,5,4,9,4,9,4
