12
1,7,7,7,5,6,1,7,5,5,7,4
3,12,10,8,1,13,5,13,5,7,13,4
11,4,11,4,2,2,3,5,5,15,5,4
11,6,9,7,13,13,13,5,7,13,6,2
10,11,7,14,3,5,4,3,12,2,9,14
10,8,10,11,14,3,7,13,6,11,7,12
9,5,14,8,8,9,12,1,13,14,11,4
2,3,14,2,2,1,7,5,5,12,11,6
11,14,11,14,11,7,13,5,7,4,8,8
10,10,8,10,10,11,6,3,15,6,3,6
10,10,1,15,12,10,11,14,10,11,14,10
8,8,1,13,4,8,8,8,8,8,8,8
