12
1,7,5,5,5,5,5,7,5,7,7,6
3,15,5,6,3,5,7,13,5,12,10,10
10,10,1,13,13,5,15,5,5,5,12,10
11,14,2,1,6,3,13,5,5,5,7,14
10,11,13,7,13,13,6,1,5,5,14,10
10,10,3,14,2,3,14,3,4,3,12,10
10,10,10,11,14,9,12,11,4,11,4,10
10,10,8,10,9,5,5,13,6,11,5,14
10,9,7,15,7,7,5,5,12,10,2,10
10,1,14,10,8,9,5,5,7,13,12,10
11,7,12,11,5,7,5,5,13,5,7,14
8,9,4,9,5,13,5,5,4,1,12,8
