12
1,5,7,7,5,5,7,5,5,5,7,4
1,5,14,9,6,3,13,5,5,5,15,6
1,5,12,1,14,9,5,7,5,5,13,14
3,7,5,5,15,5,5,13,5,5,7,14
10,9,5,7,13,5,7,7,5,6,10,10
11,5,4,9,4,3,14,11,4,11,14,10
11,5,6,3,6,9,12,11,4,10,10,10
10,1,14,10,9,7,5,13,5,14,10,10
10,3,13,15,5,13,5,5,6,10,10,10
10,9,4,9,7,5,5,5,14,9,13,14
11,7,4,1,13,7,5,5,15,4,2,10
8,9,5,5,5,13,5,5,13,5,12,8
