12
1,7,4,3,7,5,5,7,5,5,7,6
3,14,3,12,11,5,5,15,5,5,12,10
10,9,12,1,15,4,3,15,5,5,5,12
11,5,5,5,15,4,9,13,7,5,5,6
9,5,7,5,13,7,5,5,15,4,1,14
1,7,13,5,4,11,6,3,14,2,1,14
3,13,5,7,4,9,12,10,11,14,3,12
9,6,3,13,5,5,4,10,10,10,11,6
3,14,9,5,6,3,7,14,10,11,14,10
10,9,7,5,13,12,8,11,15,14,10,10
11,4,11,5,5,7,6,10,10,11,14,10
9,4,9,5,4,8,8,8,8,8,8,8
