12
1,7,7,5,5,5,4,1,5,5,5,6
2,10,11,5,7,5,4,3,7,6,3,14
10,11,15,4,9,5,4,10,8,11,12,10
10,10,9,5,5,5,7,14,2,11,7,14
10,10,3,5,7,5,12,11,15,14,10,10
11,12,10,1,14,3,6,10,10,10,10,10
10,2,11,4,10,9,14,8,10,8,8,8
10,9,13,4,10,2,11,5,13,5,7,4
9,5,7,4,11,14,10,3,5,7,13,4
1,5,13,7,14,11,14,10,1,13,7,6
3,7,5,14,8,10,9,14,3,5,12,8
8,9,4,9,5,12,1,12,9,5,5,4
