12
1,7,5,6,3,6,1,7,7,5,5,4
1,14,1,13,12,11,5,12,10,2,3,4
2,11,5,4,2,9,7,4,10,10,10,2
10,10,2,2,10,3,13,5,13,13,15,12
11,13,13,15,14,9,5,6,1,7,13,4
10,1,7,12,11,7,6,9,7,13,5,4
10,1,15,4,8,9,12,1,15,5,5,6
10,3,13,7,6,2,3,5,13,7,4,10
11,14,1,14,9,15,14,3,5,15,4,10
10,10,1,15,4,8,8,10,1,13,6,10
10,8,3,15,4,2,3,15,6,1,15,14
9,4,8,9,5,13,12,8,9,5,12,8
