12
1,6,3,7,7,5,5,6,3,7,7,4
2,10,10,10,8,2,1,15,14,10,10,2
10,11,14,11,6,10,3,14,8,8,9,12
10,10,10,10,8,10,11,13,5,5,7,4
11,12,10,9,6,9,15,7,5,6,10,2
8,1,13,5,14,3,14,11,6,11,12,10
3,7,7,7,12,9,12,10,11,14,3,14
8,10,8,9,5,5,7,12,10,11,14,10
3,13,4,3,7,4,9,6,10,11,15,14
10,2,3,14,11,6,3,12,10,10,10,10
11,13,12,10,10,8,9,6,10,10,10,10
9,5,4,8,9,5,5,13,12,8,8,8
