12
1,6,2,3,6,1,5,7,5,7,5,4
1,15,15,14,9,5,5,15,5,13,5,6
3,12,10,9,5,5,4,10,3,6,2,10
9,5,13,7,5,6,2,10,11,15,14,10
1,5,5,13,7,13,13,14,10,10,10,10
3,4,3,5,12,3,6,11,14,10,11,14
11,6,9,7,6,11,12,10,10,10,10,10
10,9,7,12,10,10,2,8,8,11,14,10
10,2,10,2,10,11,14,3,5,14,11,14
10,11,14,11,15,14,11,14,1,14,10,10
11,14,11,14,8,8,8,10,1,13,12,10
8,8,8,8,1,5,5,13,5,5,4,8
