12
1,5,5,5,6,3,5,5,7,5,5,6
1,5,7,5,13,13,7,5,15,5,5,12
1,7,13,5,4,1,14,1,13,7,5,6
3,13,5,7,4,3,13,5,5,13,6,10
10,3,7,12,3,13,5,7,6,2,10,10
10,10,11,4,10,3,6,8,9,15,14,10
11,14,9,6,10,9,14,2,3,14,10,10
10,10,3,12,10,3,15,13,14,8,10,10
10,11,13,5,15,12,8,1,15,4,10,10
9,12,1,7,12,1,7,5,13,5,13,14
2,3,6,10,2,1,15,5,5,5,4,10
9,12,9,13,13,5,13,5,5,5,5,12
