12
1,5,7,7,5,6,2,3,6,2,1,6
1,7,12,8,2,10,9,12,11,13,5,12
3,13,5,6,11,15,5,5,13,7,5,6
11,7,7,14,10,8,1,5,7,13,7,12
10,11,14,10,11,4,1,7,13,5,13,4
10,10,10,10,10,3,6,9,5,5,7,4
10,10,10,11,14,9,13,7,7,5,13,4
10,10,10,9,13,5,7,12,9,7,5,4
11,12,10,1,5,5,14,2,3,13,4,2
9,7,12,3,7,6,10,10,9,7,4,10
1,13,6,10,10,10,11,14,2,11,7,14
1,5,13,12,8,9,12,9,13,12,8,8
