12
1,7,5,5,5,7,4,1,7,7,5,4
3,15,6,3,5,13,7,5,12,10,2,2
10,10,10,10,1,7,13,7,6,10,10,10
11,14,10,10,1,12,1,12,10,11,14,10
10,10,11,15,7,7,5,7,14,10,10,10
10,8,8,10,10,11,6,10,11,12,9,14
10,1,7,12,8,9,12,10,11,6,2,10
11,5,15,5,5,5,7,12,10,9,15,12
11,6,9,5,5,5,14,2,9,6,9,6
10,10,2,3,7,6,10,10,3,14,2,10
8,10,9,14,8,9,14,10,10,10,11,14
1,13,5,13,5,5,13,13,12,9,12,8
