12
1,6,3,4,1,5,5,5,7,5,5,6
3,14,11,6,2,3,5,5,13,5,7,12
8,11,12,9,15,15,5,7,5,5,13,6
1,15,5,4,10,11,6,10,3,7,6,10
2,11,5,4,11,12,9,14,8,10,10,10
10,11,5,5,12,3,6,11,5,14,10,10
9,13,5,7,4,9,13,14,3,15,14,10
1,6,3,13,5,4,1,14,11,14,10,10
3,13,13,5,5,7,7,12,10,10,11,14
9,5,6,3,5,14,10,2,10,8,10,8
2,3,15,12,1,14,9,13,14,1,13,6
9,12,9,5,5,13,5,5,12,1,5,12
