12
1,7,5,5,5,5,7,7,5,5,4,2
3,13,5,5,5,4,8,9,7,5,5,14
11,5,5,5,5,7,5,5,13,5,6,10
11,6,3,5,5,15,5,5,7,5,12,10
10,11,15,5,4,11,5,7,13,5,4,10
8,10,11,5,4,11,6,9,7,4,3,14
3,14,9,5,6,9,12,1,15,5,14,10
10,10,3,7,13,7,5,5,13,4,8,10
8,11,12,9,4,9,5,5,6,2,2,10
1,13,5,7,4,2,2,2,11,15,14,10
3,4,2,11,4,11,15,14,10,8,11,14
9,5,13,13,4,8,8,9,12,1,12,8
