12
1,5,7,5,5,4,3,5,5,5,7,4
1,7,15,5,5,5,15,5,5,7,13,4
1,15,13,5,5,4,10,2,3,15,6,2
1,13,5,5,7,6,11,14,10,10,10,10
2,2,2,2,11,14,8,10,10,8,10,10
10,10,10,10,10,11,6,11,14,1,14,10
10,11,15,15,14,9,12,10,10,1,15,12
10,10,10,10,10,1,7,14,10,1,15,4
9,14,8,10,10,3,12,10,10,3,13,4
2,10,2,10,10,9,6,8,8,9,7,4
11,14,10,10,11,7,13,7,5,7,13,4
8,9,13,13,12,8,1,13,5,13,5,4
