12
1,7,7,5,5,5,5,5,5,7,6,2
2,10,10,3,6,2,3,7,7,12,11,14
10,10,10,8,11,13,14,8,10,2,10,10
11,15,15,5,14,2,9,7,13,12,10,10
10,8,8,1,15,12,1,14,3,4,11,14
10,1,5,7,12,3,6,10,11,6,10,10
11,7,7,15,7,13,12,10,8,11,15,14
10,10,8,8,8,1,5,13,6,10,10,10
11,15,7,7,6,2,3,7,14,10,10,10
10,10,8,10,8,9,12,10,8,11,15,14
10,10,3,13,5,5,5,15,5,14,10,10
8,8,9,5,4,1,5,13,4,8,8,8
