12
1,7,5,5,5,5,5,5,7,5,6,2
2,10,3,5,5,5,7,5,13,4,9,12
11,12,9,6,3,6,11,7,7,5,5,6
11,4,1,13,14,11,12,8,9,4,1,14
10,2,1,5,14,9,7,5,5,5,7,14
9,12,1,7,12,3,14,1,5,7,12,8
3,6,2,11,6,9,12,1,7,13,5,4
10,11,15,15,15,6,3,5,13,7,5,4
8,10,8,10,10,11,14,3,6,9,7,4
3,12,3,14,8,8,11,12,11,7,14,2
9,6,10,10,1,5,15,4,10,10,10,10
1,13,12,8,1,5,13,4,8,8,9,12
