12
1,6,3,5,5,7,5,5,7,5,7,6
1,14,10,3,7,13,5,5,13,5,14,10
3,12,10,10,11,5,4,2,2,3,14,10
9,7,13,12,9,7,5,13,13,14,9,12
3,14,3,5,5,15,5,6,3,12,2,2
10,10,10,2,2,11,6,9,15,5,13,12
10,11,14,10,10,9,12,3,14,2,3,6
10,10,10,11,13,6,3,12,10,10,10,10
10,10,10,10,3,13,15,4,9,15,14,10
10,10,11,15,13,6,10,3,4,10,10,10
11,15,14,10,1,14,10,9,6,10,8,10
8,8,8,8,1,12,9,5,13,13,4,8
