12
1,6,3,5,5,5,5,7,7,5,6,2
3,14,9,7,5,5,5,15,13,4,11,12
10,10,3,15,5,7,7,13,5,5,13,6
10,9,12,8,1,12,11,5,4,1,7,12
10,3,5,4,3,5,13,5,6,2,9,6
10,11,7,5,15,7,6,1,13,13,5,14
11,12,9,6,8,9,12,2,3,5,5,14
10,3,6,9,5,6,2,10,10,1,7,12
11,14,9,5,5,13,14,10,10,2,11,6
10,9,5,7,5,6,11,14,10,10,8,10
9,5,5,13,6,10,10,11,15,15,6,10
1,5,5,5,12,9,12,8,8,8,9,12
