12
1,5,5,5,5,6,3,5,7,5,5,4
3,5,7,5,4,10,9,7,13,5,5,6
10,1,13,5,5,15,7,13,5,5,6,8
10,2,3,5,4,8,11,5,7,7,15,4
11,13,13,5,5,5,13,7,12,10,11,4
11,5,5,5,6,3,6,11,4,11,15,6
11,5,7,6,10,11,12,11,6,10,10,10
10,3,12,10,10,10,3,12,11,14,11,14
10,9,4,8,11,14,10,2,10,10,10,10
9,5,7,4,10,10,10,10,9,14,10,10
1,5,15,7,14,11,14,10,2,10,10,10
1,5,12,9,12,8,9,13,13,12,8,8
