12
1,6,3,7,7,7,5,4,2,1,5,6
3,13,12,8,10,9,5,6,10,3,7,14
10,2,3,7,14,2,3,13,15,12,8,8
11,14,10,10,10,9,14,1,15,5,5,4
11,14,10,10,8,1,13,5,13,5,7,4
10,10,10,11,4,3,6,3,5,5,13,4
10,11,14,11,5,13,12,10,2,3,4,2
10,10,11,13,5,7,5,13,14,10,3,14
11,14,10,3,7,15,5,7,15,15,14,10
10,11,15,14,8,11,4,8,8,10,8,8
11,12,10,9,7,13,5,5,5,13,5,6
9,4,9,5,13,5,5,5,5,5,5,12
