12
1,7,5,5,6,2,3,7,5,5,5,4
1,14,1,5,12,11,15,15,6,2,2,2
3,13,4,3,6,10,10,10,11,14,11,14
9,5,7,12,8,10,10,10,10,11,14,10
1,5,15,5,5,12,10,10,8,8,10,10
1,5,13,5,6,3,14,10,3,4,11,14
2,3,7,5,14,9,12,10,11,7,14,10
11,14,10,2,11,7,7,13,12,8,9,14
10,11,13,15,14,10,8,2,3,6,2,10
11,14,1,14,10,11,4,9,14,8,11,14
10,10,1,14,10,9,5,7,13,5,12,8
8,8,1,12,8,1,5,13,5,5,5,4
