12
1,7,5,5,5,5,5,5,5,6,2,2
1,13,7,5,5,7,5,7,6,10,10,10
2,3,13,7,4,9,4,8,9,15,15,14
10,11,7,13,7,5,7,5,5,15,14,10
10,10,8,3,14,1,13,5,6,8,8,8
11,14,3,12,10,3,7,5,13,5,5,6
8,10,11,6,10,9,12,1,7,5,7,12
3,12,10,9,14,2,2,1,13,6,10,2
9,7,14,2,11,12,10,3,5,12,11,12
3,12,10,10,9,7,14,9,7,7,15,6
10,2,10,9,6,10,11,7,12,10,10,8
9,12,9,5,13,12,8,9,4,8,9,4
