12
1,5,5,5,7,5,5,5,4,3,6,2
1,5,5,7,15,5,5,7,6,10,11,14
1,5,6,10,10,3,6,10,10,8,8,10
2,3,13,14,11,12,8,8,9,7,7,12
10,11,4,10,11,5,5,7,6,10,9,6
10,10,2,11,14,3,6,10,10,10,2,10
9,15,14,10,10,9,14,10,11,15,15,14
2,10,11,14,11,5,13,12,8,10,11,14
11,14,10,10,11,5,5,5,5,14,10,10
10,11,14,9,13,7,5,7,5,13,12,10
8,10,9,6,2,11,5,13,7,5,4,10
1,12,1,12,9,13,5,5,13,5,4,8
