12
1,5,7,7,4,3,7,7,5,5,5,4
3,7,12,9,6,10,9,15,5,5,5,4
10,9,6,3,13,14,3,13,5,5,5,6
10,3,15,15,6,10,11,5,5,5,7,12
10,10,10,10,10,10,9,5,5,5,13,6
10,10,10,11,14,11,6,1,7,6,1,14
10,10,11,14,10,9,12,3,12,11,7,12
11,14,10,10,9,5,5,13,6,10,11,4
8,11,12,8,1,5,5,7,12,10,11,4
2,9,7,5,5,5,5,13,6,8,9,6
9,5,13,6,1,7,5,5,13,5,5,12
1,5,5,12,1,13,5,5,5,5,5,4
