12
1,5,7,5,4,1,7,7,5,5,5,4
2,2,11,5,5,5,15,13,5,7,5,4
10,10,10,3,5,7,13,4,1,15,5,4
9,15,13,12,3,13,5,4,2,9,7,6
1,13,7,4,11,5,5,6,11,5,12,8
1,5,15,4,10,3,6,10,9,7,4,2
3,7,13,6,10,9,14,11,5,13,5,14
10,10,1,15,13,7,13,13,5,7,5,12
11,14,2,10,1,15,4,1,6,10,2,2
10,10,11,15,6,10,3,5,13,13,15,12
10,10,10,10,9,14,11,6,3,5,13,6
8,9,12,8,1,13,12,9,12,1,5,12
