12
1,7,7,5,5,5,4,1,7,7,5,4
1,13,13,5,7,7,5,5,13,15,5,4
2,3,5,5,13,15,4,1,6,9,5,6
10,11,7,5,5,13,5,5,12,3,7,14
11,14,11,6,3,5,5,6,2,10,10,10
10,8,8,11,12,3,6,10,10,11,14,10
10,1,7,12,2,11,12,11,14,10,10,10
10,2,10,2,11,15,5,12,9,12,10,10
10,10,10,11,14,10,3,5,5,4,11,12
11,14,10,10,9,15,15,5,5,5,12,2
10,11,15,12,3,13,15,5,5,5,6,10
9,12,9,4,9,5,13,5,5,5,13,12
