12
1,6,3,6,2,2,3,5,5,5,7,4
3,13,14,10,10,11,14,3,7,6,11,4
10,2,10,9,14,10,10,8,10,10,9,6
11,15,15,7,14,10,10,3,12,10,3,12
10,10,10,10,11,12,9,13,6,11,13,6
10,10,10,10,10,3,6,1,12,10,1,12
10,10,9,14,11,13,12,3,5,13,5,6
10,10,2,10,11,7,5,14,1,5,7,12
10,10,9,14,8,8,1,12,1,7,13,4
10,11,5,15,5,7,7,6,3,15,7,4
11,14,3,13,4,8,8,10,10,8,9,4
8,8,9,5,5,5,5,13,13,5,5,4
