12
1,7,6,2,1,5,6,2,2,3,7,4
3,12,9,15,5,5,13,15,14,10,11,4
9,6,3,13,5,5,5,15,13,14,9,6
3,13,12,3,5,5,5,12,3,15,7,14
9,7,5,13,5,5,5,5,14,10,11,14
2,10,1,5,6,3,6,3,12,10,10,10
10,10,1,7,12,9,14,11,5,14,10,10
11,14,3,15,6,1,13,15,4,10,10,10
8,9,12,10,8,2,2,11,6,10,10,10
3,6,2,11,4,11,12,8,11,15,15,12
10,11,14,10,2,10,3,5,12,8,9,6
8,8,9,13,13,13,13,5,5,5,5,12
