12
1,7,7,7,5,6,3,7,7,5,7,4
2,10,8,10,3,14,8,8,10,1,15,4
11,15,7,14,10,10,1,5,15,5,13,6
10,8,8,10,8,10,3,5,13,5,5,14
11,5,4,10,3,13,13,6,3,6,2,10
9,5,6,9,12,3,6,9,14,9,14,10
3,6,10,2,3,13,12,1,13,6,10,10
10,11,15,14,10,2,2,3,5,12,10,10
10,10,10,10,10,11,14,9,5,4,11,12
10,10,10,9,15,12,10,3,5,7,14,2
11,14,8,1,15,4,8,11,4,8,9,14
8,9,5,5,13,5,5,13,5,5,4,8
