12
1,7,6,2,3,6,3,7,7,7,6,2
1,12,11,15,12,9,12,8,8,8,11,12
2,3,15,14,3,6,1,6,3,5,15,4
9,12,8,9,14,10,3,13,13,6,9,6
1,7,7,6,11,13,13,6,3,13,7,14
2,11,15,14,11,7,6,8,9,6,10,10
11,14,10,11,14,9,12,2,2,10,10,10
10,10,10,10,11,5,5,15,13,12,10,10
10,10,11,14,11,5,5,15,7,6,10,10
8,10,10,10,11,4,2,8,8,9,15,12
1,13,12,9,13,6,10,2,3,5,15,6
1,5,5,5,5,13,12,9,12,1,12,8
