12
1,7,7,7,5,5,5,7,5,5,5,6
2,10,10,9,5,5,5,15,6,1,7,14
11,14,11,7,5,5,5,13,14,3,14,10
11,14,10,9,5,7,6,2,11,14,11,14
10,8,10,2,3,14,9,14,10,10,10,10
10,1,14,11,14,11,6,10,10,10,10,10
10,3,14,10,10,9,12,11,14,10,10,10
10,8,9,14,11,5,5,14,8,9,14,10
9,5,6,8,11,5,5,13,5,4,11,14
3,6,9,6,11,4,2,2,2,2,10,10
10,11,5,15,14,2,11,15,15,12,10,10
8,8,1,12,9,13,12,8,9,5,12,8
