12
1,6,2,2,3,6,2,1,5,5,5,6
1,15,15,14,10,10,11,5,5,5,7,12
1,12,8,9,14,10,10,2,1,7,13,4
3,5,5,7,12,8,10,11,5,13,5,4
9,5,7,13,5,5,12,10,1,5,7,6
1,5,15,5,6,3,6,10,3,5,12,10
3,5,13,6,11,13,12,10,9,5,6,10
9,5,4,8,11,7,6,11,5,5,15,14
3,4,3,5,12,10,9,14,1,6,10,10
9,5,13,5,6,10,2,11,5,13,12,10
3,5,5,5,14,10,10,9,5,5,7,12
9,5,5,4,8,8,9,5,5,5,13,4
