12
1,7,5,5,5,5,6,3,4,3,6,2
3,15,7,6,3,6,10,9,5,14,9,14
10,10,10,11,14,10,11,6,3,13,6,8
10,11,14,8,8,10,10,11,14,3,15,6
10,10,10,3,5,13,12,10,9,14,11,14
10,10,11,13,6,3,6,10,2,11,14,10
9,12,8,1,14,9,13,14,10,10,10,10
3,7,5,5,15,5,5,13,14,10,10,10
8,11,5,5,13,5,7,5,13,12,8,8
2,10,2,2,1,5,15,5,6,3,7,6
10,10,11,14,3,5,13,4,9,12,10,8
9,13,12,9,13,5,5,4,1,5,13,4
