12
1,5,5,7,5,4,2,1,7,7,7,6
2,1,7,13,6,2,11,6,10,10,11,14
11,6,10,2,11,13,14,9,12,8,10,10
10,11,14,11,13,5,15,6,2,2,10,10
10,10,11,15,7,4,8,11,14,11,14,10
10,10,10,10,8,3,7,12,9,12,10,8
10,10,10,11,6,9,12,3,5,4,10,2
10,10,10,10,11,7,5,13,5,6,9,14
9,14,9,14,10,9,5,7,4,8,1,14
3,14,1,15,14,2,3,13,5,5,5,14
8,11,7,12,9,15,13,5,5,5,7,12
1,12,9,4,1,13,5,5,5,5,13,4
