12
1,7,5,5,5,5,5,5,5,5,7,6
2,9,5,5,7,5,5,6,3,7,14,10
10,1,7,7,15,5,5,15,14,10,10,10
11,5,14,10,8,3,5,12,8,11,14,10
10,1,14,11,5,13,7,6,2,10,10,10
10,1,12,9,4,3,14,10,10,10,11,14
11,5,7,7,6,9,12,10,11,14,11,14
9,4,10,8,8,2,1,14,10,10,10,10
2,2,10,2,2,11,5,13,12,11,12,10
9,15,13,13,12,10,1,5,5,15,6,10
3,15,7,4,2,10,1,5,5,14,10,10
8,8,9,5,13,12,1,5,5,12,9,12
