12
1,6,3,5,5,6,3,7,5,7,7,4
2,11,14,2,1,14,10,11,4,10,9,6
10,10,10,11,5,13,12,11,4,8,1,14
9,14,11,14,3,5,5,13,5,4,1,12
1,14,10,10,11,5,5,5,5,5,5,6
1,12,8,10,10,3,6,3,5,5,5,12
3,5,5,13,12,9,13,15,5,5,6,2
9,6,1,7,7,5,5,13,7,4,10,10
2,10,1,14,9,5,6,3,15,6,10,10
9,14,1,13,7,4,11,12,8,10,11,14
1,15,5,5,15,4,9,6,2,10,10,10
1,12,1,5,13,4,1,13,12,9,13,12
