12
1,7,5,5,5,5,7,5,5,5,5,6
3,13,5,7,5,6,9,7,4,1,7,12
11,7,6,10,1,14,3,13,5,7,13,4
10,10,10,10,3,14,11,5,5,13,5,4
10,10,10,10,10,8,9,6,2,1,5,6
11,14,10,11,14,3,7,14,10,2,3,14
10,11,14,10,10,9,12,10,10,10,10,10
10,10,11,14,9,7,5,13,12,11,14,10
10,10,9,15,5,13,5,7,5,14,10,10
10,10,3,13,5,5,5,13,6,10,10,10
11,14,9,5,7,5,5,5,13,14,10,10
8,9,5,5,12,1,5,5,5,13,12,8
