12
1,5,5,5,5,7,7,5,5,5,7,4
3,5,7,7,5,13,13,5,5,5,15,4
11,7,13,14,1,5,5,7,7,5,13,4
10,9,4,11,5,5,5,12,9,5,7,6
11,7,5,13,5,5,7,7,7,7,14,10
10,10,2,2,2,3,14,8,10,8,10,10
11,14,10,11,14,9,12,3,13,7,12,10
10,11,15,14,11,6,3,15,5,14,1,14
10,10,10,11,14,11,14,10,3,14,1,14
10,9,14,10,10,10,10,10,10,10,1,14
11,4,10,10,10,10,10,10,8,10,1,14
9,4,8,8,8,8,8,8,1,13,5,12
