12
1,5,7,4,3,7,5,7,5,5,5,6
2,2,11,7,14,9,5,13,4,3,6,10
11,13,12,9,13,5,7,5,4,10,10,10
11,6,2,3,5,7,13,5,5,14,10,10
10,11,14,11,7,13,5,7,6,10,10,10
10,8,9,12,8,3,6,8,10,11,15,14
9,5,7,4,2,9,13,7,13,14,10,10
1,5,15,5,13,6,3,13,6,10,10,10
3,7,13,5,5,12,11,4,9,15,15,14
9,15,5,5,7,4,11,7,6,10,10,10
3,14,3,6,9,7,12,10,8,10,10,10
8,9,12,9,5,12,1,13,4,8,8,8
