12
1,6,3,5,5,7,5,4,3,4,2,2
3,15,13,6,3,13,5,5,15,7,14,10
10,10,2,9,13,5,5,6,10,8,9,12
10,10,10,1,5,5,7,13,15,5,5,4
8,9,14,3,7,7,13,6,10,2,3,6
3,5,12,10,8,11,6,10,10,10,10,10
9,5,5,15,6,9,12,11,14,11,14,10
1,5,5,14,10,2,2,10,10,10,10,8
1,7,5,12,10,10,10,10,11,14,9,6
3,13,5,7,15,14,10,10,11,14,3,12
11,6,2,10,10,11,12,9,15,13,15,4
8,9,12,8,8,9,5,5,13,4,9,4
