12
1,6,2,2,2,3,5,4,1,7,5,4
1,13,13,14,11,14,3,6,2,10,2,2
1,5,5,15,12,9,12,9,15,14,10,10
1,6,2,9,7,5,5,4,10,10,10,10
1,14,10,2,11,5,5,6,10,9,13,12
3,15,15,15,15,7,6,8,9,7,5,4
10,10,10,10,10,9,12,2,2,10,3,6
11,14,10,10,9,6,3,12,11,15,14,10
10,10,10,11,7,14,11,5,14,8,8,8
10,11,14,10,10,10,11,5,15,5,5,4
8,11,12,8,10,11,15,5,13,5,5,4
1,13,5,5,12,8,9,5,5,5,5,4
