12
1,6,2,2,2,2,1,5,5,5,5,6
3,14,11,15,13,14,1,5,5,7,7,14
10,10,10,8,1,12,1,5,5,14,10,10
10,10,11,5,7,5,5,5,5,14,11,14
10,11,13,6,11,5,5,7,5,13,14,10
10,11,7,13,14,3,7,13,6,2,10,10
11,12,11,6,10,9,12,3,13,12,8,10
9,6,8,8,11,5,7,15,5,4,3,14
1,13,5,5,15,5,14,9,5,7,14,10
3,7,7,7,13,5,13,7,5,14,10,10
10,10,10,9,7,5,5,13,4,10,10,10
8,8,8,1,13,5,5,5,5,12,9,12
