12
1,6,3,5,5,5,7,4,3,5,5,4
3,15,15,7,5,5,13,4,9,7,5,4
10,10,11,13,5,5,5,5,5,13,7,4
10,10,9,5,5,6,2,2,1,7,15,6
10,11,7,6,3,13,13,15,5,14,10,10
10,10,10,9,14,3,6,8,1,12,8,10
11,14,9,6,10,9,13,6,3,5,6,10
9,15,6,10,9,6,1,14,11,4,9,14
3,12,8,11,5,14,3,15,13,4,1,12
11,5,6,10,3,14,9,13,6,2,2,2
10,1,14,8,8,9,5,7,12,10,10,10
9,5,13,5,5,4,1,13,5,13,13,12
