12
1,5,5,7,5,5,7,7,7,5,4,2
3,5,5,13,5,4,10,8,10,3,6,10
10,1,7,5,5,4,11,4,9,12,9,14
11,5,15,5,5,5,15,7,5,5,4,10
9,5,13,5,7,4,8,9,5,7,5,12
2,3,5,7,15,7,6,3,5,13,5,4
10,10,3,14,8,9,12,11,5,5,7,4
10,10,10,10,3,7,6,10,3,7,14,2
10,10,10,9,12,10,10,11,12,8,11,12
11,15,14,3,5,12,11,14,2,1,15,4
11,14,8,9,5,4,10,10,11,5,15,4
8,9,5,5,5,5,12,8,8,1,13,4
