12
1,6,1,7,5,5,4,3,6,2,3,6
2,11,5,13,7,5,6,10,11,14,10,10
10,10,1,5,15,4,9,14,10,11,14,10
10,10,3,6,11,7,4,8,10,8,8,10
10,10,8,11,12,11,5,5,13,7,5,12
11,13,7,13,4,11,6,3,5,13,5,4
10,3,15,7,4,9,12,9,5,5,5,6
11,14,10,9,7,5,5,7,4,1,7,12
10,10,10,3,12,1,5,13,5,5,13,6
11,14,10,11,5,7,5,7,5,5,5,12
10,10,10,8,1,15,5,13,7,5,5,4
8,9,12,1,5,13,4,1,13,5,5,4
