12
1,6,2,2,3,6,2,1,7,4,1,6
2,11,14,10,8,9,13,5,15,7,7,12
9,14,9,14,3,6,3,5,12,10,9,4
2,10,2,10,10,9,13,7,4,11,6,2
9,13,12,9,14,1,5,13,6,10,10,10
1,5,5,7,12,3,6,1,14,10,10,10
2,3,4,10,2,9,13,7,13,14,11,12
11,15,4,10,10,1,7,14,3,14,10,2
10,11,5,13,15,5,12,10,10,10,9,14
10,9,5,5,15,4,2,10,10,10,1,14
10,3,7,7,13,6,10,11,14,10,2,10
9,12,8,8,1,13,12,8,8,9,13,12
