12
1,5,5,6,3,4,3,5,6,3,5,6
3,5,5,13,13,6,10,1,13,13,6,8
9,5,5,6,2,11,15,5,5,5,15,4
2,1,6,10,11,14,11,5,5,5,13,6
10,3,12,10,10,8,9,7,7,7,6,10
11,13,7,13,15,7,6,8,10,8,11,14
10,1,14,2,10,9,12,2,11,4,10,10
10,2,10,11,15,5,7,15,13,6,10,8
10,10,11,14,8,3,12,8,1,12,11,6
10,11,15,13,7,13,4,1,6,3,14,10
11,14,10,3,13,5,5,7,12,10,10,10
8,8,8,9,5,5,4,9,5,12,8,8
