12
1,7,5,7,6,1,5,7,5,5,6,2
3,14,3,14,11,7,5,13,5,5,13,12
10,11,15,14,10,9,5,7,5,7,6,2
10,10,10,10,10,2,3,13,4,10,11,14
10,10,10,10,10,9,13,7,6,10,11,14
10,10,10,10,10,3,6,10,8,8,10,10
9,14,8,9,14,9,13,15,5,5,14,10
3,13,5,4,9,7,5,13,4,3,12,8
10,3,6,2,1,13,7,5,4,10,2,2
10,10,8,11,5,5,13,5,6,11,14,10
9,13,7,13,7,5,5,5,12,10,10,10
1,5,12,1,13,5,5,5,5,12,9,12
