12
1,7,5,5,5,5,5,4,2,3,7,4
1,15,5,5,5,5,7,6,10,10,9,6
3,13,5,5,5,5,13,14,10,10,1,14
10,3,4,2,3,5,5,13,15,12,1,14
10,9,6,10,11,7,5,6,10,3,6,10
11,5,15,14,10,11,6,10,10,10,10,10
8,3,12,10,10,9,12,11,15,14,9,14
2,9,6,11,14,3,7,12,10,10,2,10
10,3,12,10,10,8,10,1,13,14,10,10
10,11,4,10,10,3,13,5,4,9,15,14
10,9,5,14,9,13,7,5,6,3,15,12
9,5,5,13,5,5,13,4,9,12,9,4
