12
1,6,1,5,5,7,5,7,6,3,6,2
3,15,7,5,5,13,6,11,13,14,9,12
10,10,9,5,7,4,11,14,3,13,7,6
10,10,2,3,13,6,10,10,9,4,8,10
10,10,11,14,3,12,8,10,1,5,5,14
10,11,12,11,14,3,6,10,1,7,5,12
11,15,6,10,11,13,12,9,5,13,7,4
10,10,11,14,10,1,5,5,7,5,13,6
11,14,10,10,10,3,5,5,13,7,5,14
10,11,14,10,11,15,5,5,5,13,6,10
10,10,10,11,14,11,5,5,5,7,12,10
8,8,8,8,8,9,5,5,4,9,5,12
