12
1,7,7,5,5,7,6,2,1,7,4,2
3,14,10,3,7,12,10,10,3,15,4,10
10,10,10,10,10,2,11,15,15,15,7,14
10,10,11,14,11,14,10,10,8,10,10,10
11,14,10,10,10,8,8,11,4,11,14,10
10,11,14,10,10,3,6,11,4,10,10,10
8,8,8,9,15,13,12,9,6,10,11,14
3,7,7,4,9,7,5,7,13,12,8,10
10,10,9,7,7,13,5,13,4,2,3,14
8,8,3,12,9,5,7,5,5,14,10,8
3,6,9,7,5,5,13,5,5,15,13,4
8,9,5,13,5,5,5,5,5,13,5,4
