12
1,7,6,3,6,1,6,3,5,5,5,6
3,12,8,10,10,3,15,13,7,4,3,14
9,6,2,10,9,14,10,3,13,4,10,10
3,13,13,15,4,10,8,9,5,4,11,14
9,7,4,9,7,13,5,5,5,6,10,10
3,13,5,5,12,3,6,3,6,9,14,10
9,7,5,7,6,11,12,10,9,5,12,8
1,14,3,12,10,11,5,13,5,5,6,2
3,13,13,6,8,11,7,7,5,4,9,12
10,2,2,11,6,10,10,10,3,5,5,4
9,14,11,12,8,10,10,9,13,5,7,4
1,12,9,5,5,12,9,5,5,5,13,4
