12
1,5,6,2,3,5,5,5,5,7,7,4
3,5,13,13,13,7,5,5,5,12,11,6
11,5,5,5,5,13,7,6,2,2,10,8
9,7,5,4,3,7,12,9,13,12,11,4
3,13,5,4,9,13,5,6,3,7,13,4
10,3,6,2,2,3,7,14,10,11,7,6
11,14,10,10,10,9,12,10,11,15,14,10
10,10,10,11,14,2,2,11,14,10,10,10
10,10,9,12,11,14,10,10,10,10,10,10
11,13,5,4,10,10,10,10,10,10,10,10
10,2,2,2,10,11,12,10,9,12,11,12
8,9,13,13,12,9,5,12,1,5,13,4
