12
1,7,6,3,5,4,3,7,5,5,5,4
2,10,10,11,7,5,15,13,5,5,5,6
11,14,10,8,9,6,9,7,7,5,4,10
8,8,11,5,5,14,3,12,9,6,2,10
3,5,13,7,7,12,9,6,1,14,11,14
8,1,7,12,8,3,6,10,1,14,10,10
1,5,13,5,6,11,12,11,5,15,12,10
3,5,5,5,15,12,3,12,1,13,7,12
10,3,7,7,14,2,10,1,7,7,13,4
11,12,8,10,10,11,14,3,12,11,7,6
10,3,5,12,9,12,10,11,4,8,10,8
8,9,5,5,5,5,13,13,4,1,13,4
