12
1,6,2,3,5,5,7,5,5,6,2,2
3,14,11,15,5,5,13,5,7,15,14,10
10,10,11,12,1,6,2,2,10,10,11,14
10,11,15,4,3,14,9,15,12,8,10,8
10,8,9,6,10,9,5,15,5,5,15,4
10,1,6,11,15,7,6,10,3,5,14,2
9,7,13,12,8,9,12,10,10,3,15,14
2,11,5,7,5,5,7,12,10,10,10,10
9,15,5,12,3,6,10,2,11,15,14,10
1,13,7,4,8,9,13,15,14,10,10,10
3,7,13,7,7,5,7,13,12,8,11,12
8,8,1,12,9,5,13,5,5,4,9,4
