12
1,6,1,7,5,7,5,5,5,5,7,6
3,14,1,15,4,10,3,5,5,5,13,14
10,11,7,13,4,11,15,7,7,6,3,14
10,10,9,7,4,8,8,10,10,10,11,14
10,11,5,13,7,5,5,12,11,15,14,10
10,10,3,5,14,3,6,3,12,10,10,10
11,14,10,2,10,9,13,13,6,11,14,10
10,10,10,11,14,2,2,1,12,8,10,8
10,10,8,10,9,13,12,3,5,7,13,4
10,11,5,15,4,3,6,10,3,12,2,2
10,11,5,13,4,10,10,8,9,7,13,12
9,13,5,5,5,12,9,5,5,13,5,4
