12
1,6,2,3,5,7,4,1,5,7,5,6
3,14,10,10,2,11,6,3,7,13,4,10
8,11,14,10,10,10,10,10,9,7,4,10
3,15,15,12,9,12,9,14,3,13,4,10
10,8,9,7,7,5,4,10,9,5,6,8
9,6,2,10,10,3,7,15,5,6,11,6
2,10,10,11,14,9,12,10,1,14,10,10
10,11,12,10,9,6,2,11,7,13,12,8
11,13,5,12,1,14,10,10,9,7,5,4
9,7,5,4,1,15,15,14,2,11,5,4
1,13,5,7,5,14,10,10,11,13,5,4
1,5,5,13,5,13,12,8,9,5,5,4
