14
1,6,3,6,2,2,2,3,5,5,5,5,7,4
2,11,12,10,11,14,9,13,7,7,7,7,14,2
11,14,1,15,14,11,6,2,11,12,8,10,9,12
10,10,1,14,10,10,10,10,10,3,5,13,7,4
10,10,1,14,8,8,11,13,12,10,1,7,13,4
10,10,2,10,2,3,13,5,6,11,7,13,7,6
9,13,14,11,15,14,3,6,10,10,9,6,10,10
1,6,11,12,10,8,9,14,10,10,3,13,15,14
3,14,10,1,14,2,1,14,10,10,11,4,10,10
10,11,14,3,15,13,5,13,13,13,13,6,10,10
10,10,10,9,13,5,5,7,7,5,5,14,8,8
10,11,15,7,7,5,5,13,13,5,4,9,5,6
11,14,8,11,13,5,7,5,4,2,3,7,7,12
8,9,4,9,4,1,13,5,5,13,12,8,9,4
