14
1,7,5,6,2,2,3,7,5,7,5,5,7,4
3,15,6,10,10,10,10,10,3,13,5,5,15,4
10,8,8,10,10,10,10,10,10,1,5,5,13,6
9,5,7,14,10,10,10,11,12,3,4,2,2,10
2,3,14,11,15,13,15,15,4,9,6,11,14,10
10,10,8,11,13,7,12,9,6,3,13,12,8,10
10,11,5,12,1,15,7,6,10,11,6,1,7,14
11,13,5,4,1,14,9,12,11,14,9,5,12,8
10,2,2,2,3,13,5,7,13,13,7,5,5,4
11,14,10,11,14,3,6,11,5,7,13,4,2,2
10,9,13,12,11,12,10,10,3,15,7,6,10,10
11,5,5,4,11,6,11,14,10,8,8,9,13,14
10,2,2,3,14,11,14,10,9,5,5,5,6,10
9,13,13,12,8,8,8,8,1,5,5,5,12,8
