14
1,5,7,5,5,5,5,5,6,3,6,2,2,2
1,5,13,5,5,5,5,6,11,14,10,10,10,10
2,2,3,5,5,5,5,12,10,10,11,15,14,10
11,15,13,7,5,5,5,6,10,8,8,8,9,14
10,10,3,13,7,5,5,12,9,6,1,7,7,14
10,8,9,5,13,7,5,5,5,15,5,12,8,10
11,5,5,5,7,12,3,6,3,13,5,5,4,10
10,1,7,5,13,4,9,13,13,5,5,5,6,10
11,7,13,7,5,5,5,5,7,5,5,5,15,12
10,10,1,13,7,4,3,5,12,1,5,5,15,4
10,10,3,5,15,5,13,5,7,5,5,5,13,6
10,11,15,6,11,7,5,5,13,7,5,5,7,12
10,10,8,10,10,9,6,2,3,13,5,5,15,4
9,12,1,13,12,1,13,13,13,5,5,5,13,4
