14
1,7,5,5,5,5,7,5,7,5,5,5,5,6
1,15,5,5,7,4,9,6,11,4,3,5,5,12
2,9,7,4,11,6,1,15,14,2,9,7,5,4
9,5,13,6,8,11,7,12,10,11,5,13,5,6
1,7,4,10,3,12,11,4,9,14,3,5,5,12
1,13,7,12,9,6,9,4,3,14,10,3,6,2
3,6,9,7,7,12,3,6,8,10,11,12,8,10
10,9,7,12,11,6,9,13,7,14,9,7,5,12
11,7,13,5,14,9,5,5,12,11,5,13,5,6
10,11,5,7,13,5,4,2,2,11,4,3,7,12
10,10,1,13,7,5,5,15,13,15,5,14,9,6
10,8,1,5,13,6,3,14,2,9,6,10,1,14
11,5,5,4,1,15,14,10,10,2,10,10,3,12
9,5,5,5,5,12,8,9,12,9,12,8,9,4
