14
1,6,1,6,3,4,2,1,6,2,2,3,6,2
2,11,5,13,14,2,10,1,14,11,13,14,10,10
10,9,7,4,10,11,15,5,15,13,4,8,11,14
10,1,13,6,11,14,11,5,15,5,5,5,14,10
11,5,5,12,10,10,11,5,13,7,5,5,14,10
10,1,5,7,12,10,9,5,5,15,5,4,9,14
11,5,7,14,3,14,3,6,3,13,5,5,4,10
10,1,15,15,14,11,13,12,11,7,7,4,2,10
10,1,12,10,10,11,7,5,12,10,9,5,13,12
9,5,6,10,10,8,11,5,5,15,4,2,2,2
3,4,10,10,8,1,13,7,5,15,4,11,14,10
10,2,10,10,2,2,3,14,1,15,4,10,10,10
11,14,10,9,14,9,14,8,1,15,5,12,9,12
8,9,13,5,13,5,13,5,5,13,5,5,5,4
