14
1,5,7,5,7,7,7,4,1,6,3,4,2,2
1,7,12,2,10,10,11,5,7,13,13,5,13,14
3,13,4,9,14,11,15,6,11,5,7,7,4,10
9,5,4,1,14,10,10,10,9,6,10,10,2,10
1,6,2,2,10,10,10,10,2,10,10,10,10,10
1,14,11,15,14,10,8,9,13,14,10,11,15,14
3,14,10,8,10,10,3,6,2,10,10,10,10,10
8,11,13,4,9,12,11,12,10,11,14,8,10,10
2,9,5,6,1,5,13,5,15,13,13,5,13,14
9,7,5,12,1,7,5,5,13,7,5,5,5,12
1,13,5,7,5,13,7,5,7,15,5,5,5,4
1,7,5,13,5,4,11,4,11,15,7,6,3,6
2,11,6,3,6,2,9,6,10,8,8,9,12,10
9,12,9,12,9,13,5,13,13,5,5,5,4,8
