14
1,6,1,7,4,3,7,5,5,5,5,7,5,6
2,10,2,11,4,10,10,3,5,5,5,15,4,10
11,14,11,15,6,10,10,10,2,2,3,13,6,10
8,9,12,10,9,14,11,15,15,13,12,1,12,10
1,7,5,13,5,12,10,11,13,7,5,5,5,14
1,13,7,5,5,5,12,9,7,15,5,5,5,12
1,7,13,5,5,6,3,6,11,13,7,5,5,4
1,15,7,6,2,10,9,14,9,5,15,5,5,6
1,14,10,11,15,15,7,13,5,5,15,6,2,10
3,14,10,10,10,10,10,1,7,5,12,11,14,10
10,10,10,10,10,10,10,1,13,7,4,10,10,10
10,11,14,10,10,10,10,3,6,10,3,14,10,10
10,10,11,13,14,9,14,10,11,13,14,10,11,14
8,8,8,1,13,4,9,12,8,1,12,8,8,8
