14
1,6,3,7,5,5,5,5,7,7,5,7,5,6
1,14,8,9,7,5,5,5,14,9,4,10,3,12
2,10,3,5,15,5,5,5,13,5,5,12,9,6
9,13,12,3,13,7,7,5,7,5,5,4,3,14
2,2,3,13,4,9,15,5,15,4,1,7,12,10
10,11,13,7,6,3,12,1,15,6,3,14,2,10
10,10,1,14,10,10,3,6,10,10,10,11,12,10
11,14,3,14,11,14,9,13,14,10,8,9,6,10
10,8,10,11,14,10,2,3,14,9,5,5,13,14
10,3,15,14,11,13,13,14,11,5,5,5,4,10
10,10,10,10,9,5,4,8,11,5,5,5,7,12
11,14,10,9,5,7,5,4,9,5,7,5,15,4
10,10,10,3,5,15,4,1,7,6,11,5,13,6
8,8,8,8,1,13,5,5,12,9,12,1,5,12
