14
1,7,5,5,5,5,5,5,5,7,7,7,7,4
1,15,6,2,1,7,5,5,7,12,10,10,9,6
1,12,9,15,5,15,7,7,12,2,11,14,2,10
2,3,7,14,3,12,8,9,5,14,10,10,10,10
10,10,10,9,14,3,5,5,5,13,14,11,13,14
10,10,11,7,13,13,5,5,7,4,8,8,3,12
10,10,10,10,2,2,3,6,11,7,7,6,11,6
10,10,10,10,10,10,11,12,10,8,10,11,14,8
10,11,14,9,15,12,11,4,11,4,10,10,11,6
11,12,9,5,15,4,9,6,11,6,10,10,8,10
11,5,5,5,15,4,1,15,14,10,10,10,1,14
11,5,7,5,13,5,5,14,8,9,14,10,1,14
9,5,15,5,5,6,1,15,5,5,13,15,7,12
1,5,13,5,5,13,5,13,5,5,5,12,9,4
