14
1,5,7,5,5,5,6,2,3,5,5,5,7,4
1,6,11,4,3,4,10,10,11,7,5,5,13,4
3,12,11,5,13,7,14,11,14,11,7,5,5,4
11,5,15,4,1,12,10,10,10,11,13,7,7,6
11,5,13,7,5,4,9,14,9,14,3,14,10,10
10,2,3,12,2,2,1,13,6,10,10,11,14,10
11,13,13,5,13,15,7,6,11,15,14,10,10,10
11,5,5,7,5,12,9,12,10,10,10,10,11,14
10,2,3,14,2,3,7,7,12,8,8,8,10,10
11,15,14,11,14,10,10,11,5,5,5,5,14,10
10,10,10,8,11,15,15,14,1,5,5,5,13,14
11,14,11,5,14,10,10,10,3,7,5,5,5,12
10,10,10,3,15,14,10,10,11,13,5,7,5,4
8,9,12,8,8,8,8,9,13,5,5,13,5,4
