14
1,6,3,7,5,5,5,7,5,5,5,7,4,2
3,15,14,10,2,1,5,13,6,1,5,15,4,10
10,10,10,10,11,7,5,5,12,2,1,13,7,14
10,10,10,11,14,9,5,5,6,11,7,5,12,10
10,8,8,10,8,1,7,6,10,8,9,5,4,10
10,3,7,15,4,3,12,11,15,7,5,5,5,12
11,12,8,9,7,12,3,14,11,13,5,5,5,6
9,7,5,5,12,2,9,12,11,4,2,3,6,10
2,10,1,5,6,11,6,1,13,7,14,10,10,10
10,10,1,5,14,10,11,7,5,12,9,12,10,10
9,15,7,5,12,11,15,15,5,5,5,5,15,14
3,12,11,6,3,14,9,13,7,5,5,5,12,10
9,6,8,11,12,10,3,5,13,5,7,5,6,10
1,13,5,13,5,12,9,5,5,5,13,4,9,12
