14
1,7,5,5,7,5,5,7,5,5,5,5,6,2
1,15,6,2,11,7,7,13,7,5,5,4,11,12
1,14,11,15,14,8,10,3,13,7,5,5,13,4
3,14,10,10,11,6,8,11,5,13,5,5,5,4
10,10,8,8,11,13,7,13,5,7,5,5,6,2
10,10,2,2,10,3,13,7,5,15,5,5,15,12
10,9,13,15,14,10,3,14,1,13,7,4,10,2
10,2,2,10,10,10,9,12,1,5,15,4,10,10
11,14,11,12,10,10,3,6,1,5,13,6,9,14
10,9,14,2,10,11,14,10,1,5,7,12,1,12
10,2,10,11,13,14,10,10,1,7,12,1,5,6
10,11,13,14,2,10,11,15,6,10,3,7,5,12
10,9,6,11,14,10,10,10,9,13,14,9,5,6
9,5,12,8,8,9,12,9,5,5,12,1,5,12
