14
1,7,5,5,5,5,7,4,3,5,7,5,5,6
1,15,7,7,6,1,13,6,11,4,10,3,6,10
1,14,10,10,10,3,5,13,13,4,10,8,10,10
1,15,14,10,11,15,6,1,5,7,12,3,15,12
3,14,10,11,14,10,8,1,5,15,5,14,11,4
11,14,10,10,10,11,5,5,5,15,4,8,10,2
10,8,11,12,9,12,3,6,3,15,7,6,11,14
11,5,15,4,2,2,9,14,10,8,8,8,8,10
10,3,12,3,13,13,5,15,12,3,7,5,7,14
10,10,3,14,3,5,5,13,5,14,8,3,12,8
10,11,14,11,13,5,5,5,6,10,1,13,6,2
8,8,10,10,3,7,6,2,11,15,5,5,13,14
1,7,12,10,10,10,9,13,14,8,3,5,7,12
1,13,5,12,8,8,1,5,13,4,9,4,9,4
