14
1,6,2,1,5,7,5,5,5,7,5,6,2,2
1,14,10,1,5,14,3,7,7,15,6,11,15,14
3,14,9,5,7,12,10,10,10,8,8,10,8,8
10,11,7,5,13,6,10,8,9,5,6,9,6,2
10,10,11,4,1,13,13,7,5,4,8,1,14,10
8,11,13,7,5,4,1,13,7,5,5,5,13,14
1,13,7,13,5,7,7,6,9,7,5,5,4,10
1,5,14,1,6,10,9,12,3,13,7,5,5,12
1,5,13,5,14,10,3,5,15,5,13,5,7,4
3,5,5,4,10,11,15,5,13,7,5,4,11,4
9,5,7,5,14,10,11,5,5,13,7,5,14,2
3,5,13,4,10,10,10,2,2,2,11,6,11,14
10,3,7,6,11,14,11,14,11,15,12,8,10,10
9,12,8,8,8,8,8,9,12,9,5,4,8,8
