14
1,7,5,7,7,5,5,5,5,7,6,3,5,6
1,12,3,12,11,6,3,5,5,12,11,15,4,10
1,5,15,4,8,10,9,5,5,6,10,11,4,10
3,5,13,6,2,10,3,5,7,14,8,9,4,10
11,5,4,10,11,15,12,1,13,13,6,2,2,10
10,2,2,11,12,11,5,5,5,5,15,15,15,14
10,10,10,10,1,12,3,6,3,5,14,8,8,8
10,11,14,9,7,4,9,14,11,6,11,6,3,6
11,12,9,5,13,7,5,15,12,11,12,11,14,8
11,5,5,5,7,13,7,12,1,15,4,10,11,4
9,5,7,5,13,4,9,6,1,13,4,8,11,4
2,3,15,6,2,2,3,15,7,7,7,6,11,4
11,12,8,9,13,15,14,10,10,10,8,9,13,4
9,5,5,5,5,12,8,8,9,13,5,5,5,4
