14
1,7,5,6,1,5,5,5,7,4,2,2,3,6
3,13,4,10,3,5,5,5,13,7,14,10,10,10
10,3,4,10,9,5,5,7,7,14,11,15,14,10
11,13,6,10,3,7,5,12,8,8,10,8,8,10
8,1,15,15,15,15,7,7,5,5,13,5,7,14
3,6,10,10,10,10,8,9,7,5,7,5,12,8
8,9,14,8,8,10,3,6,10,3,14,3,5,6
2,2,10,3,6,10,11,12,11,12,9,12,3,12
11,14,9,14,10,11,13,5,15,5,7,4,10,2
10,10,3,15,14,9,7,5,13,5,13,4,10,10
8,9,14,8,11,7,13,5,5,7,5,7,13,14
2,1,14,2,10,11,5,5,7,13,5,13,5,12
10,3,14,10,10,10,3,7,13,5,7,5,5,4
9,12,9,13,12,8,8,9,5,5,13,5,5,4
