14
1,7,5,6,3,6,2,3,7,4,3,7,5,4
2,10,2,10,8,9,15,14,9,7,14,11,7,6
11,15,15,13,5,5,14,8,3,12,10,10,10,10
10,10,10,2,1,7,13,4,9,4,10,10,10,10
10,10,11,14,2,11,5,5,5,7,13,14,10,10
10,8,8,9,13,15,7,5,5,15,4,10,11,14
9,6,2,3,6,10,11,6,1,15,4,10,10,10
3,13,13,14,10,10,9,12,3,14,3,15,15,14
9,7,6,10,10,10,3,7,14,9,12,8,8,10
1,12,10,10,11,14,10,9,13,5,5,7,6,10
2,3,12,11,14,11,15,5,7,5,5,13,12,10
9,15,5,14,10,10,9,5,15,5,5,7,5,14
1,13,6,8,9,12,1,5,13,7,5,13,6,10
1,5,13,5,5,5,5,5,5,13,5,5,13,12
