14
1,6,1,6,2,2,3,7,7,5,5,7,5,4
1,13,5,14,10,10,8,10,8,3,7,14,2,2
1,5,5,14,10,10,3,14,2,10,10,10,11,14
1,5,5,15,13,15,14,8,10,10,8,10,10,10
1,5,7,13,5,15,13,4,11,12,3,13,12,8
1,7,13,5,4,11,5,5,14,3,15,5,5,6
3,13,7,5,5,12,3,7,14,10,10,3,6,10
10,2,11,6,3,6,9,12,10,10,8,8,11,12
10,10,10,11,12,9,5,5,14,11,5,5,15,4
11,14,10,10,1,5,6,1,15,12,3,5,13,4
10,11,14,10,1,5,14,3,15,4,9,5,7,4
10,10,11,14,2,2,11,14,11,5,7,4,9,6
10,10,10,11,15,15,14,10,11,4,11,5,5,12
9,12,9,12,8,8,8,8,9,5,13,5,5,4
