14
1,7,5,6,1,7,5,7,6,2,3,6,3,6
1,13,4,11,7,12,1,12,11,14,10,10,10,8
3,5,5,12,9,5,7,4,8,10,10,10,11,6
10,2,3,5,7,5,13,5,7,13,14,11,12,10
11,13,15,5,13,5,5,7,13,4,10,10,3,14
10,1,14,2,2,3,5,13,7,6,11,14,10,10
10,1,13,14,9,14,3,6,10,10,10,10,11,14
10,2,3,15,6,10,11,12,10,10,10,10,10,10
10,11,14,8,11,14,11,4,10,10,10,9,14,10
11,14,9,4,8,9,15,7,14,10,11,6,10,10
11,14,2,3,5,6,8,8,9,15,12,9,14,10
10,11,15,15,5,13,7,5,4,10,1,5,13,12
10,10,10,11,5,5,15,5,5,13,5,7,5,6
8,8,8,9,5,5,13,5,5,5,5,13,4,8
