14
1,6,1,5,7,5,5,7,4,3,7,7,7,6
1,14,1,5,15,4,3,15,4,10,10,10,10,10
1,15,5,5,15,4,8,11,5,12,8,8,8,10
1,13,7,5,12,2,3,13,7,5,5,5,7,12
1,5,15,5,5,14,9,7,13,5,4,2,11,4
1,7,13,5,4,11,5,13,5,5,6,10,10,2
1,13,7,5,6,11,7,6,1,5,14,10,11,14
3,5,13,5,14,10,9,12,3,5,13,15,14,8
11,7,7,6,11,15,5,5,13,5,4,8,9,4
10,10,10,10,11,13,5,7,5,5,5,5,5,6
10,10,10,10,9,7,5,13,5,7,6,1,7,14
11,15,15,14,1,13,7,5,5,14,10,1,12,10
10,10,10,10,3,5,13,6,1,14,8,1,5,14
8,8,8,9,12,1,5,13,5,13,5,5,5,12
