14
1,7,5,7,5,5,5,6,3,5,7,5,5,4
3,15,6,10,3,7,6,10,11,5,15,5,5,4
11,14,10,10,10,8,11,13,12,3,15,5,6,2
10,11,15,14,8,3,13,5,7,12,8,1,15,12
10,10,10,11,7,14,3,5,13,5,5,6,10,2
10,10,10,10,10,11,13,7,7,4,1,14,10,10
10,10,10,8,8,10,3,14,11,5,6,10,10,10
10,11,12,1,5,14,9,12,9,4,11,13,15,14
10,11,7,7,7,14,3,5,7,5,13,4,10,8
10,10,8,10,10,10,10,2,10,1,7,4,10,2
11,14,2,10,11,15,13,15,13,5,13,7,15,14
10,10,10,10,10,9,5,13,7,5,7,14,8,8
11,15,15,15,14,2,2,3,15,5,13,13,7,4
8,8,8,8,8,9,13,12,9,5,5,5,13,4
