14
1,6,2,1,7,5,5,5,5,5,7,6,3,6
3,12,10,3,13,7,5,5,5,6,10,11,14,10
11,7,15,14,1,14,2,2,1,14,10,10,10,10
8,10,8,9,5,15,14,9,7,12,8,10,8,8
2,11,7,6,3,14,10,3,13,5,5,15,5,4
10,10,10,10,10,8,9,13,7,5,5,13,5,4
11,14,10,11,15,4,3,7,13,5,7,5,5,6
10,8,8,10,10,2,9,12,3,7,13,7,4,10
10,1,7,12,11,14,2,2,8,11,4,10,2,10
10,2,11,7,15,14,9,15,5,13,6,9,14,10
10,11,12,8,10,10,3,14,1,5,12,1,13,14
10,9,5,6,10,10,10,10,1,5,5,7,4,10
11,5,5,14,10,11,14,11,7,5,5,13,5,14
9,5,5,12,8,9,13,12,9,5,5,5,5,12
