14
1,7,5,7,7,5,6,3,5,5,5,5,5,4
1,12,3,13,15,6,10,10,3,6,3,7,5,6
1,6,10,2,10,10,9,13,12,9,14,11,6,10
3,12,10,10,10,10,1,5,5,7,14,11,14,10
9,5,13,14,10,10,1,5,7,12,8,10,10,10
1,5,7,12,10,11,5,5,13,7,5,14,10,10
1,6,11,5,14,10,3,6,1,13,6,10,11,12
3,13,13,6,9,12,9,14,3,5,13,12,9,4
10,2,3,13,7,5,5,13,13,7,5,6,3,6
11,14,10,1,13,5,7,5,5,15,5,14,10,10
10,9,14,1,5,5,15,7,5,13,4,11,14,10
10,2,10,3,7,5,13,13,5,7,5,12,10,10
11,14,10,11,13,5,5,5,6,11,7,4,11,14
8,9,13,13,5,5,5,5,13,12,9,4,8,8
