14
1,5,5,5,7,5,5,5,7,5,6,1,7,6
1,6,3,7,12,3,5,6,9,7,13,5,14,10
3,13,14,9,7,14,1,13,7,13,4,2,10,10
11,4,10,3,12,10,1,7,13,5,6,11,12,10
9,6,10,9,4,10,3,13,5,6,10,11,7,14
1,14,9,5,4,11,12,3,5,14,11,12,10,8
3,13,5,5,7,12,3,14,2,10,11,7,13,6
10,2,3,7,13,4,9,12,10,10,10,11,4,10
11,15,14,9,7,5,5,5,15,13,14,11,7,14
11,14,10,3,15,5,5,5,15,4,10,10,10,10
10,10,10,8,10,3,7,5,13,6,8,8,10,10
10,10,11,7,13,14,11,7,6,11,5,6,10,10
10,10,10,9,4,8,8,10,9,15,6,10,9,14
9,13,13,5,5,5,5,13,4,8,8,9,5,12
