14
1,7,5,5,5,7,5,6,2,3,4,1,7,4
3,13,5,7,7,15,5,14,11,15,4,3,13,4
9,7,6,8,8,8,1,15,14,9,5,13,5,6
2,10,11,6,2,2,2,9,13,7,7,5,6,10
9,14,10,10,11,15,15,5,5,12,8,3,13,12
1,14,10,10,10,11,15,5,5,5,7,12,2,2
1,15,14,11,12,10,11,6,1,5,13,7,13,14
3,12,9,14,1,12,9,12,2,1,5,14,1,14
11,7,7,15,5,5,5,5,13,5,5,14,3,12
11,14,10,9,7,5,5,7,5,5,5,12,11,4
10,10,9,5,13,6,2,9,7,7,5,5,13,6
10,10,1,7,5,12,11,5,13,15,5,5,4,10
10,11,5,13,6,3,14,3,5,12,2,2,3,14
8,8,1,5,13,12,8,9,5,5,13,13,12,8
