14
1,6,2,1,7,5,7,5,5,5,5,7,7,6
2,10,11,5,15,6,10,2,3,5,5,13,14,8
10,10,10,3,12,10,11,15,15,5,5,7,13,4
9,13,14,9,5,15,14,8,11,5,5,13,5,4
2,2,10,3,4,10,11,4,11,5,5,7,5,4
10,10,11,15,6,10,11,4,9,7,6,11,5,6
10,10,8,8,10,10,11,6,1,14,9,13,4,8
11,15,7,7,13,12,9,12,3,15,6,2,3,6
10,10,10,10,3,5,5,7,12,8,10,11,14,10
11,14,10,11,14,2,1,13,5,6,11,14,10,10
10,10,11,12,10,10,2,2,2,10,10,10,10,10
10,10,10,3,12,11,15,15,15,14,10,10,8,10
10,9,14,11,4,10,10,8,8,9,14,9,7,12
9,4,9,13,5,12,9,5,5,4,8,1,13,4
