14
1,6,3,7,7,5,5,6,1,7,7,4,3,6
1,13,12,10,9,4,2,11,5,12,11,5,14,10
1,5,7,13,6,3,14,11,7,5,13,4,10,10
1,5,13,6,11,14,11,14,11,5,5,7,15,14
1,7,5,12,8,10,8,10,11,6,2,10,10,10
3,14,1,6,2,10,1,14,10,10,10,10,10,10
10,9,5,13,13,14,3,14,10,11,15,14,10,10
11,5,7,5,5,12,9,12,10,10,10,10,11,14
10,3,15,5,5,5,5,7,14,10,10,10,10,10
11,14,11,7,5,5,5,12,11,14,10,10,10,10
10,10,11,15,6,1,5,6,10,8,9,15,12,8
8,9,12,10,11,5,5,12,10,3,7,15,5,4
3,7,7,13,13,5,5,5,14,10,10,9,5,4
8,8,9,5,5,5,5,4,8,8,9,5,5,4
