14
1,7,6,2,3,6,1,7,5,7,5,5,5,6
2,10,10,10,10,9,5,15,4,8,3,6,2,10
10,10,11,13,12,3,5,13,7,6,8,11,13,12
10,10,10,1,5,13,7,5,14,9,6,11,7,6
11,14,10,3,7,7,14,2,11,4,10,10,10,10
8,9,15,12,10,10,9,12,11,4,11,14,10,10
3,5,13,6,10,10,3,6,9,6,10,10,10,10
11,5,4,10,11,14,9,13,5,14,10,11,14,10
11,6,2,11,14,11,6,3,5,13,12,8,10,10
10,11,14,8,8,8,9,15,5,5,5,7,12,10
10,10,11,6,2,1,7,13,5,5,7,13,4,10
10,10,10,10,10,1,13,5,5,5,13,5,6,10
10,10,10,10,11,7,5,5,5,5,5,7,13,14
8,9,12,9,12,9,5,5,5,5,5,13,4,8
