14
1,7,7,5,5,5,5,6,1,7,5,5,5,4
3,15,13,5,5,5,6,10,3,13,5,5,5,6
10,11,7,5,5,5,12,11,15,4,3,5,6,10
10,10,11,5,5,5,4,10,11,5,13,4,9,14
9,15,13,5,5,5,4,10,9,5,7,4,2,10
1,13,5,7,5,7,7,13,7,5,13,4,10,10
3,5,5,13,7,12,11,6,9,5,7,4,11,14
11,6,3,7,14,2,9,12,3,5,13,4,10,10
10,8,10,10,10,10,2,3,14,3,7,7,14,10
10,3,15,15,15,12,10,10,11,14,10,10,10,10
11,14,10,10,9,7,14,10,11,14,11,14,10,10
10,8,8,10,3,12,10,10,10,10,10,10,10,10
9,7,4,10,9,4,9,12,10,10,10,9,14,10
1,13,5,13,5,5,5,5,12,9,12,1,13,12
