14
1,5,6,1,7,6,3,6,1,7,5,5,5,4
2,2,10,3,14,11,14,9,5,13,4,1,5,6
10,11,14,8,8,8,9,5,7,5,4,2,2,10
10,10,9,5,5,5,5,5,13,5,7,14,11,14
10,11,7,5,5,5,6,3,7,7,14,11,14,10
11,12,10,1,5,7,15,12,8,10,8,10,10,10
11,6,10,3,6,10,11,6,3,13,7,12,8,8
10,11,14,8,9,14,9,12,11,6,10,1,6,2
10,10,11,6,2,10,3,7,14,11,15,5,15,14
10,10,10,11,15,13,14,8,11,14,10,3,12,10
10,10,8,10,9,4,11,4,10,10,8,9,4,8
9,12,1,14,3,5,13,4,10,9,5,7,5,4
3,5,4,10,10,2,3,6,10,3,5,13,6,2
9,5,5,12,9,13,12,9,13,13,4,1,13,12
