14
1,5,5,7,5,5,6,2,1,6,2,3,7,6
3,7,7,15,6,2,11,13,5,13,13,14,10,8
10,8,8,10,9,12,9,7,5,5,6,10,10,2
11,5,6,11,7,7,5,15,5,4,10,11,14,10
11,4,8,10,10,10,1,15,5,4,10,10,11,14
11,5,5,12,8,10,1,13,7,6,9,12,10,10
9,5,5,7,5,14,3,6,8,10,3,5,12,10
2,2,2,11,6,10,11,12,1,15,15,4,3,14
11,13,15,14,8,9,15,5,5,12,9,7,12,10
10,2,10,10,3,6,10,3,5,7,5,13,4,10
10,10,10,9,14,10,10,9,5,15,5,5,4,8
10,10,11,7,12,11,14,1,7,13,7,5,5,6
10,11,14,11,5,12,11,5,15,6,10,1,6,10
9,12,8,9,5,4,8,1,12,9,13,5,13,12
