14
1,6,1,7,5,5,5,5,5,5,7,5,5,4
2,11,7,13,5,5,7,5,5,7,13,5,5,4
10,10,11,5,5,5,13,7,5,13,5,5,5,6
10,10,11,5,5,5,5,15,5,5,7,5,4,10
11,14,11,5,5,5,5,15,5,5,13,7,5,14
10,11,13,5,5,5,5,13,5,5,5,13,6,10
10,10,2,3,5,7,7,6,1,7,5,5,12,10
10,11,15,15,4,10,9,12,3,13,5,5,4,10
11,14,10,11,6,10,3,5,13,5,5,6,3,14
10,10,10,10,10,10,10,1,7,5,5,12,10,10
10,11,14,10,10,11,14,1,13,7,5,4,11,14
10,10,10,10,10,11,15,5,7,13,5,5,14,10
8,11,12,11,15,14,10,2,9,7,5,6,10,10
1,13,5,12,8,8,8,9,5,13,4,9,12,8
