14
1,7,4,1,5,5,7,4,3,5,5,5,7,4
2,9,7,7,5,5,13,5,15,6,2,3,13,6
10,3,14,10,2,3,5,6,10,10,9,13,4,8
11,12,8,9,13,13,6,8,10,10,1,5,5,6
9,7,5,5,5,7,13,4,10,10,3,5,5,12
3,14,2,2,1,15,7,5,14,10,10,2,1,6
11,14,10,10,1,14,11,6,11,15,15,14,1,14
10,11,14,10,3,12,9,12,10,8,8,11,5,12
10,10,9,15,13,5,5,5,15,6,3,13,6,2
10,10,1,14,3,6,2,3,13,13,14,3,12,10
10,10,3,12,10,9,13,12,1,5,14,9,5,14
9,14,10,2,10,2,1,7,5,5,14,1,5,14
3,12,11,13,15,13,5,15,5,4,11,5,5,12
9,5,13,4,9,4,1,13,5,5,13,5,5,4
