14
1,7,5,6,1,5,5,7,5,5,5,5,5,6
3,12,3,14,3,7,5,13,5,5,6,3,6,10
10,3,12,11,12,9,5,5,7,5,13,14,11,14
10,10,3,12,2,3,7,7,13,7,4,8,8,10
11,14,9,6,11,14,8,9,6,10,2,3,5,12
10,10,1,15,12,9,4,1,13,13,13,13,7,6
10,9,6,9,7,4,3,6,3,4,2,3,13,14
11,5,13,5,15,5,13,12,9,6,9,14,1,12
11,6,3,6,11,7,7,6,3,13,5,15,5,4
10,10,11,14,10,10,10,11,13,6,2,9,5,6
10,11,12,10,10,10,11,13,6,10,10,3,7,14
10,11,4,10,10,10,10,3,14,10,10,10,10,10
10,9,6,11,14,10,10,10,10,10,10,10,10,10
9,5,12,9,12,8,8,8,8,9,13,12,8,8
