14
1,5,7,5,6,3,5,5,7,5,5,5,6,2
3,5,14,1,14,9,6,1,14,2,1,6,11,12
9,4,8,3,12,3,13,5,15,13,5,12,9,4
1,5,5,13,7,13,5,6,11,5,7,5,5,4
3,5,5,5,12,3,5,13,13,5,13,5,7,4
11,5,4,2,2,11,5,5,7,5,5,5,15,4
11,5,4,11,13,14,3,6,9,5,5,7,14,2
9,5,5,15,4,10,9,14,1,7,5,12,10,10
1,7,5,13,4,10,2,11,5,14,2,2,10,10
2,10,3,5,4,11,14,9,6,11,15,14,11,14
11,13,13,7,4,10,9,5,12,10,10,8,10,10
9,4,1,15,5,13,5,5,6,10,10,3,14,10
2,2,1,15,7,6,2,1,14,10,11,13,14,10
9,13,5,12,8,9,13,5,13,12,8,1,13,12
