14
1,7,5,7,6,2,2,3,5,5,5,7,5,6
1,15,4,10,11,15,15,14,3,5,5,15,5,12
3,12,2,10,8,11,14,11,15,5,5,13,7,4
10,2,10,10,2,10,10,10,11,6,3,4,11,6
11,15,15,15,14,10,8,8,8,11,13,4,10,10
10,10,10,10,11,14,1,5,5,13,5,5,14,8
10,8,10,8,8,8,3,6,3,5,6,2,11,6
11,6,9,7,5,5,13,12,10,2,10,11,14,10
10,11,7,15,7,5,5,5,12,11,15,14,10,10
10,10,10,10,11,7,5,5,5,12,10,10,10,10
11,12,10,10,11,15,5,5,5,7,14,9,15,14
10,3,12,10,10,9,4,3,5,12,11,4,10,10
10,11,4,11,15,5,5,15,5,4,9,6,10,10
8,9,5,12,9,5,5,13,5,4,1,13,12,8
