14
1,7,6,1,7,4,1,7,7,6,3,4,1,6
1,14,8,3,15,4,1,14,10,9,13,5,7,12
3,15,6,8,11,5,5,12,11,5,7,7,14,2
10,10,10,3,15,5,5,6,9,4,10,10,10,10
11,15,15,14,9,7,5,13,5,6,10,10,10,10
10,10,10,9,7,13,5,5,7,15,15,15,14,10
10,10,10,3,13,6,3,6,10,10,10,10,11,14
8,10,8,11,5,14,9,13,14,10,11,14,11,14
1,15,4,10,1,13,5,7,14,11,14,11,14,10
2,10,3,14,1,7,4,10,10,8,8,8,10,8
10,10,10,10,1,13,7,12,8,1,5,6,11,6
10,10,10,11,6,2,9,6,3,7,6,11,12,10
11,14,10,10,11,15,5,13,12,10,11,14,3,14
8,9,12,8,8,9,5,5,4,8,8,8,8,8
