14
1,7,5,5,4,1,7,5,7,5,5,7,4,2
1,13,5,5,7,7,13,5,13,7,5,13,4,10
3,5,7,5,13,13,5,5,5,15,5,5,5,14
11,5,13,5,5,5,6,2,3,14,3,5,7,12
9,7,5,5,7,4,11,15,15,13,12,1,13,6
2,10,2,3,13,6,8,8,10,3,7,7,7,12
10,11,14,9,6,10,3,7,14,10,10,10,10,2
10,10,9,7,12,8,9,12,10,10,10,11,14,10
11,14,2,10,1,5,5,7,14,10,10,10,11,12
10,8,9,13,5,7,6,10,11,13,14,10,9,6
10,3,6,2,2,10,9,12,9,6,11,12,1,14
11,14,9,13,14,10,1,7,5,12,10,3,5,12
10,10,3,5,12,10,1,13,5,6,9,14,3,6
8,8,9,5,5,13,5,5,5,13,5,13,12,8
