14
1,6,1,6,3,5,5,5,5,5,6,3,7,6
3,13,5,13,13,7,6,3,5,5,13,14,8,10
10,2,2,2,1,13,13,13,7,5,7,15,6,10
10,10,11,13,7,5,5,5,14,1,14,10,10,10
10,11,13,5,13,7,5,5,13,6,11,14,11,14
10,9,5,5,5,15,5,5,6,10,10,10,10,10
11,7,5,5,5,14,3,6,10,9,14,11,15,14
9,14,2,3,6,10,11,12,10,1,14,10,10,10
1,14,10,10,10,11,13,5,15,5,12,11,12,10
3,12,10,11,15,14,1,5,13,5,6,11,4,8
11,7,15,14,10,10,1,5,5,5,14,10,1,6
8,10,8,10,10,10,3,5,5,5,12,9,5,14
3,13,5,12,8,11,13,5,5,5,7,7,5,12
9,5,5,5,4,8,1,5,5,5,12,9,5,4
