14
1,5,7,5,4,3,5,5,7,5,4,3,7,6
2,2,11,5,5,13,7,5,15,5,5,12,8,10
11,14,10,3,7,4,9,7,14,2,2,3,5,14
10,10,11,14,10,3,7,14,10,11,15,14,3,12
10,11,14,10,9,14,10,10,11,14,10,11,13,6
10,10,10,10,3,12,8,8,10,10,10,10,1,14
10,8,10,8,9,4,3,6,10,11,14,10,3,12
11,7,13,5,5,4,11,12,10,10,8,10,9,4
11,15,5,5,7,5,13,7,12,8,3,15,5,4
10,10,3,5,13,5,5,15,7,5,12,9,7,4
10,10,10,3,7,7,6,10,11,5,5,5,15,4
10,10,9,14,8,8,9,13,15,5,5,5,13,6
10,9,5,15,7,5,5,5,13,7,5,5,5,12
9,5,5,13,13,5,5,5,5,13,5,5,5,4
