14
1,7,4,2,3,6,3,7,5,7,5,5,5,6
3,13,5,14,10,10,10,10,3,14,2,2,2,10
10,2,2,9,12,11,12,10,10,9,13,13,13,14
9,13,14,1,5,14,1,14,11,5,5,5,7,12
2,3,13,7,5,15,7,12,11,5,5,5,13,6
10,11,7,13,5,14,9,5,15,6,2,2,3,14
10,10,9,5,6,10,3,7,14,11,15,14,8,10
11,14,2,3,14,10,9,12,10,11,14,11,5,14
8,10,11,12,10,11,6,3,14,10,10,8,1,14
1,12,8,3,12,10,9,13,14,10,10,1,6,10
3,5,5,13,7,14,3,6,11,14,10,1,13,14
10,3,7,4,10,9,12,8,10,10,9,5,5,14
10,10,9,6,11,7,5,6,10,8,1,7,5,12
9,12,1,12,8,8,1,12,9,5,5,13,5,4
