14
1,7,5,5,5,7,5,7,5,5,5,5,7,4
2,10,2,2,3,13,5,13,5,7,5,5,13,4
11,14,11,15,15,5,5,5,5,13,7,5,5,4
10,10,10,10,10,2,2,3,7,7,14,3,7,6
10,9,12,8,11,13,15,14,8,8,9,12,10,10
11,7,6,2,11,5,12,11,7,6,3,7,13,14
8,10,10,10,10,2,3,14,10,9,14,8,1,12
2,10,10,11,13,14,9,12,11,5,13,5,7,4
9,12,9,14,1,13,5,5,14,3,7,5,15,6
3,7,5,13,6,1,7,5,12,10,10,2,10,10
8,8,3,5,13,6,9,5,6,10,10,10,10,10
1,5,13,5,6,10,3,5,12,10,10,10,10,10
1,5,5,7,14,10,9,5,6,10,11,12,10,10
1,5,5,12,8,9,5,5,12,9,13,5,13,12
