14
1,5,5,5,5,7,5,5,7,5,5,5,7,4
3,5,5,6,3,14,3,5,12,2,3,7,13,6
10,2,2,11,14,10,11,6,3,14,10,9,6,10
10,11,15,14,8,10,10,10,10,11,14,2,10,10
10,10,10,10,2,11,14,11,14,10,11,15,13,14
11,14,10,11,15,14,8,8,10,10,8,9,6,10
10,8,8,8,10,8,3,6,11,15,4,1,12,8
11,5,5,7,13,4,9,13,14,9,7,5,5,4
11,5,5,13,7,5,5,7,14,2,10,3,7,6
9,7,5,5,13,7,5,13,12,10,9,14,11,14
2,10,2,3,5,13,7,5,5,14,1,14,10,10
11,14,10,11,5,7,13,5,5,15,6,10,10,10
10,11,13,13,5,13,7,6,2,10,10,10,10,10
9,13,5,5,5,5,12,9,12,8,9,12,8,8
