14
1,5,5,5,7,5,6,2,3,5,6,3,5,4
1,7,5,5,13,7,14,10,10,3,12,10,3,6
3,13,5,5,7,12,10,9,14,9,5,13,12,8
9,5,6,3,14,2,11,5,15,5,5,5,7,4
3,6,11,14,11,12,10,3,13,5,5,5,15,4
10,9,14,10,11,6,11,13,7,5,5,7,13,4
10,2,10,10,10,10,11,6,11,5,7,13,5,4
11,15,12,11,15,14,9,12,11,5,13,5,7,4
10,11,7,12,10,11,7,7,15,5,7,5,13,4
10,8,11,4,8,10,10,10,11,5,13,5,5,4
11,5,14,2,2,10,8,11,15,5,5,5,7,4
11,4,9,13,15,14,2,10,10,3,5,5,13,4
11,5,5,6,8,9,14,10,11,13,5,7,5,4
9,5,5,13,5,4,9,12,8,1,5,13,5,4
