14
1,7,6,1,7,5,7,7,7,7,6,2,1,6
3,14,10,3,15,4,8,8,8,8,9,13,5,14
8,10,11,13,13,5,7,5,7,7,7,6,3,14
3,12,10,3,7,7,12,3,14,10,10,10,10,10
11,4,10,10,10,9,7,14,10,8,10,11,14,10
9,7,14,11,14,3,12,8,11,6,10,11,14,10
3,14,11,14,10,10,3,6,10,10,10,10,10,10
8,9,12,10,10,10,9,13,14,9,15,14,8,10
2,3,5,12,9,13,7,6,11,7,14,9,7,12
10,11,5,5,7,5,13,15,12,10,10,3,15,6
10,10,1,7,13,5,5,14,2,10,11,14,10,8
10,11,5,15,5,5,5,14,10,10,10,8,10,2
11,13,6,9,5,5,6,9,12,10,9,6,9,14
9,5,13,5,5,5,13,5,5,13,5,12,1,12
