14
1,7,6,1,5,7,7,5,6,3,7,6,2,2
3,14,10,2,1,14,9,6,11,14,10,8,10,10
10,10,10,10,3,15,7,14,10,10,11,7,15,14
10,10,10,10,10,10,8,10,10,8,8,8,8,10
8,8,11,15,12,8,2,10,9,5,7,5,7,12
3,6,10,9,7,4,9,13,5,5,14,3,15,6
10,9,14,1,13,4,3,6,3,5,12,10,10,10
10,2,11,7,7,7,13,12,11,4,3,14,10,10
11,14,10,10,10,11,7,5,13,5,12,10,10,10
8,11,12,10,10,10,9,7,5,5,4,10,8,10
1,15,4,10,10,10,3,13,4,3,5,13,5,14
1,14,2,10,11,14,11,5,5,13,5,4,3,12
3,13,12,11,12,9,14,2,3,5,5,5,13,4
9,5,5,13,5,4,9,13,13,5,5,5,5,4
