14
1,7,4,3,5,7,7,7,7,6,2,3,6,2
3,15,6,8,1,14,8,8,10,10,10,10,10,10
10,10,11,7,7,13,5,4,10,10,10,10,11,14
10,10,10,10,11,6,3,6,10,9,13,12,10,8
10,10,8,10,10,11,14,10,11,7,5,5,13,4
10,11,5,12,11,14,8,9,14,9,5,5,5,6
9,13,5,7,14,11,7,6,10,3,5,5,5,14
1,6,3,14,10,10,9,12,11,15,4,1,5,12
1,15,12,9,14,9,5,5,13,13,5,5,5,6
3,13,4,3,14,1,6,3,5,7,5,5,4,10
11,5,4,10,11,5,13,15,5,13,5,7,4,10
9,7,5,14,11,7,5,13,5,6,3,14,2,10
3,13,4,8,10,11,5,5,6,9,12,9,15,14
9,5,5,4,8,9,4,1,12,1,5,5,12,8
