14
1,6,3,6,3,5,5,5,5,7,6,3,7,6
2,10,10,8,11,6,2,2,3,14,9,14,10,10
10,11,14,3,14,10,10,10,10,11,6,10,10,10
11,14,11,12,9,15,15,14,10,10,11,13,14,10
10,10,11,5,4,10,10,10,10,10,11,4,11,14
8,11,13,5,4,10,10,9,14,8,9,4,8,10
3,13,7,5,4,8,11,6,10,3,6,3,6,10
9,5,15,6,3,6,9,12,9,14,9,12,11,14
2,3,14,9,14,11,5,7,7,15,5,4,8,8
11,12,11,6,10,10,3,12,11,13,7,5,7,4
8,1,14,11,12,10,9,6,10,1,15,4,9,4
3,7,14,10,3,15,7,14,9,5,13,7,5,6
10,8,10,9,12,8,10,11,7,5,7,13,5,12
9,5,13,5,5,4,8,8,9,5,13,5,5,4
