14
1,5,7,5,5,5,5,6,3,7,5,5,5,4
3,5,13,6,2,3,6,11,13,13,5,5,7,6
10,1,5,13,13,14,10,9,5,7,5,4,11,12
11,5,5,5,7,15,14,3,5,13,5,7,13,6
11,6,2,2,10,10,10,10,1,7,5,15,6,10
10,10,11,14,11,14,9,13,5,13,4,10,9,14
10,11,14,10,10,10,3,6,1,5,7,13,5,14
11,14,10,10,10,10,9,14,3,5,12,1,5,14
10,10,10,11,12,9,5,13,15,5,5,5,7,14
10,9,14,10,3,5,5,7,14,1,7,5,12,8
10,1,14,11,12,3,5,12,8,1,13,7,6,2
10,3,15,13,6,11,7,4,2,1,5,12,11,14
11,12,10,1,14,10,11,5,15,5,7,5,12,10
8,1,12,1,12,8,9,4,8,1,13,5,4,8
