14
1,7,7,5,7,5,7,6,3,7,7,7,7,6
3,12,9,6,10,2,10,11,12,8,8,8,8,10
9,5,6,10,9,14,11,14,1,7,5,5,5,12
1,7,12,10,1,15,14,11,7,13,5,5,5,6
2,11,6,11,7,12,10,10,11,5,7,5,5,12
10,11,14,8,11,4,8,8,9,7,13,5,5,4
11,14,9,5,13,6,3,6,3,13,5,5,7,4
10,10,1,7,5,12,9,14,10,1,6,1,14,2
10,10,3,13,5,5,6,10,10,3,12,1,14,10
10,10,10,1,7,5,12,9,15,14,2,3,13,14
10,10,10,2,10,2,2,3,14,9,13,13,4,8
10,11,14,10,10,10,11,13,13,5,5,7,6,2
11,14,10,10,10,10,10,1,5,7,5,12,10,10
8,8,9,13,13,13,13,5,5,13,5,4,9,12
