14
1,7,6,1,6,2,3,5,5,5,4,1,6,2
3,14,11,6,11,15,14,3,7,5,6,3,12,10
10,10,10,9,12,10,10,10,9,6,10,11,4,10
10,10,10,1,5,12,9,14,3,12,9,13,6,10
11,15,14,3,4,1,7,12,8,2,3,4,10,10
10,10,9,15,6,3,13,5,6,9,15,5,14,10
10,9,6,10,11,14,3,6,10,1,15,4,10,10
10,1,12,10,8,8,11,12,11,6,10,2,11,14
9,7,5,13,7,5,15,6,10,11,13,12,8,8
2,10,2,3,14,2,10,10,9,15,5,5,5,4
10,10,10,10,8,9,12,11,7,13,5,5,5,6
10,10,10,10,2,1,5,12,11,7,4,2,2,10
11,13,13,15,13,5,5,7,13,15,5,13,13,14
9,5,4,9,4,1,5,13,5,13,5,5,5,12
