14
1,7,5,5,7,5,6,1,5,5,6,3,7,6
2,11,7,5,14,1,14,2,3,6,11,14,10,10
11,14,10,1,14,1,14,10,10,10,10,10,8,10
10,10,10,3,12,1,13,13,12,9,14,10,1,14
8,10,10,11,5,5,5,5,7,5,14,8,1,12
3,12,8,11,5,5,5,5,15,5,13,5,4,2
11,7,5,13,5,4,3,7,15,7,7,7,6,10
10,11,7,5,5,4,9,12,10,10,10,10,11,12
11,14,9,5,5,5,5,6,10,8,8,8,11,6
10,11,5,5,5,5,5,15,15,5,7,6,10,10
10,10,1,7,4,1,7,12,10,1,12,11,14,10
9,15,5,13,4,1,13,6,9,7,4,10,10,10
1,15,5,5,5,5,5,12,3,13,6,10,8,10
1,13,5,5,5,5,5,5,13,5,12,8,1,12
