14
1,7,5,5,5,5,7,7,7,6,1,6,3,4
1,15,4,1,5,7,14,10,10,10,1,13,13,6
1,14,1,6,3,14,10,10,10,10,1,7,5,14
3,13,7,13,12,10,11,14,11,15,7,13,4,8
11,6,10,3,7,15,14,10,10,10,9,5,7,4
8,10,10,10,8,8,8,9,14,9,5,7,13,4
3,12,10,9,7,4,3,6,9,7,5,13,7,4
11,5,14,3,13,6,11,12,3,13,5,5,13,6
11,5,13,13,4,9,15,5,13,4,2,2,3,12
9,7,5,5,5,5,13,5,5,6,10,10,9,6
1,15,5,5,5,5,5,7,5,12,10,10,2,10
3,13,5,5,5,5,5,15,5,4,11,15,13,14
11,7,5,7,5,5,5,13,5,7,12,8,2,10
8,9,5,13,5,5,5,5,5,13,5,5,13,12
