14
1,5,6,1,6,1,7,6,3,7,7,4,3,6
3,5,12,1,14,2,10,9,12,8,11,5,12,8
11,5,5,5,13,13,15,7,7,5,15,5,5,4
9,7,5,7,4,3,12,8,9,7,13,4,3,4
3,13,4,11,6,9,5,5,6,9,6,2,9,6
9,7,4,8,8,3,5,5,14,3,12,10,3,12
1,13,7,5,4,10,3,6,10,11,6,11,15,4
1,7,13,5,7,12,11,12,10,8,11,12,9,4
3,13,5,5,13,7,13,5,13,7,15,7,7,4
11,4,2,2,2,10,3,5,5,12,8,10,11,6
11,5,15,15,15,14,11,5,5,5,6,10,10,10
11,6,8,8,8,9,13,5,5,6,10,11,12,10
11,13,7,7,4,3,6,1,5,14,11,14,3,12
8,1,12,9,5,12,9,5,5,12,8,8,9,4
