14
1,7,7,7,4,2,3,6,3,7,5,5,5,4
3,14,10,11,5,14,10,10,11,15,5,5,5,4
10,8,8,9,6,10,10,11,15,13,5,5,4,2
10,2,2,3,14,11,14,9,13,5,5,7,5,14
10,11,13,12,10,9,13,5,5,7,5,13,6,10
10,10,3,6,9,7,7,5,7,13,7,5,14,10
11,13,12,9,5,14,11,6,10,1,13,6,10,10
11,5,5,5,7,12,9,12,10,3,5,12,11,12
11,7,5,5,15,5,5,6,10,11,6,2,9,6
10,10,3,6,10,3,5,15,14,11,14,11,6,10
8,9,12,9,15,15,4,10,11,14,11,12,9,14
3,7,7,5,13,13,4,8,11,12,9,5,7,12
10,11,14,1,6,2,2,3,13,4,3,5,13,4
8,8,9,5,13,13,12,9,5,4,9,5,5,4
