14
1,7,4,3,7,5,5,5,7,5,5,7,7,6
1,15,5,14,11,7,5,4,9,5,6,10,10,10
3,13,4,10,10,11,5,5,7,5,13,14,11,14
10,2,2,10,10,11,6,2,11,6,3,14,10,10
10,10,10,11,14,8,9,15,12,9,12,10,10,10
11,15,15,14,11,7,5,13,5,6,1,14,10,10
10,10,8,8,8,8,3,6,1,15,5,13,15,14
11,13,4,2,2,3,13,12,1,15,5,4,8,8
11,7,6,10,11,13,7,7,5,13,5,7,5,6
10,10,11,13,12,3,12,10,2,1,5,15,4,10
10,10,10,2,2,10,3,14,10,1,5,15,5,14
10,10,11,15,14,10,10,11,14,1,5,15,4,10
11,15,14,10,10,11,12,10,10,1,5,15,4,10
8,8,8,8,9,13,4,8,9,5,5,13,4,8
