14
1,7,6,3,5,5,7,5,5,5,5,5,5,6
3,14,10,10,3,5,15,5,7,5,5,5,5,12
8,8,11,15,15,5,15,7,13,5,6,2,3,6
1,5,12,10,10,3,12,9,5,6,10,11,15,14
3,5,7,14,10,11,6,2,3,14,9,14,10,10
10,1,12,9,14,10,9,13,14,11,4,10,10,10
9,7,4,2,10,8,3,6,10,10,3,14,10,10
1,15,5,12,9,6,9,13,14,11,14,9,14,8
2,11,7,7,5,15,5,5,14,10,10,2,10,2
11,12,8,8,3,13,5,4,9,14,10,10,10,10
10,2,2,2,9,5,5,6,2,10,10,11,14,10
11,14,11,14,2,3,4,10,11,13,13,12,8,10
10,9,12,8,11,15,5,13,13,5,5,7,5,14
9,5,5,5,13,13,5,4,1,5,5,13,5,12
