14
1,6,3,4,2,3,7,5,5,5,5,6,2,2
3,13,13,5,13,15,13,5,7,5,7,13,12,10
11,5,5,5,5,13,7,5,13,4,9,7,5,14
11,6,3,5,5,5,15,4,2,2,1,13,4,10
10,11,15,6,3,5,13,5,15,15,5,5,5,12
10,10,10,9,13,5,5,4,10,11,7,7,5,4
10,8,11,5,5,7,7,6,11,14,10,11,5,4
10,2,9,6,2,10,9,12,10,10,10,11,5,6
11,13,5,13,14,9,7,5,14,11,14,10,3,12
10,3,6,3,13,6,10,3,14,10,10,10,9,6
9,14,11,13,6,11,13,12,11,14,11,14,1,14
1,14,8,1,12,10,3,6,10,10,10,10,1,14
3,13,5,7,5,13,12,8,10,11,13,13,7,14
9,5,5,13,5,5,5,4,8,9,5,5,12,8
