14
1,7,4,3,7,6,1,5,7,5,5,7,4,2
2,9,5,12,8,10,1,5,15,4,3,13,5,12
10,1,6,3,5,12,1,7,13,5,13,5,7,4
10,3,13,13,5,5,7,14,1,6,2,1,13,6
11,15,5,5,5,5,13,15,5,14,10,1,7,12
9,15,5,7,5,5,7,13,5,15,13,7,13,4
3,14,3,15,7,6,11,6,1,15,7,13,5,6
10,11,14,10,10,10,9,12,3,14,10,2,2,10
11,14,10,10,10,9,6,2,10,10,10,11,14,10
10,10,10,11,14,3,13,14,10,10,10,10,11,14
10,10,10,10,10,9,6,10,10,10,10,8,10,10
10,10,11,12,9,7,12,9,14,11,13,5,14,10
10,11,15,7,7,13,5,5,13,15,5,7,12,10
9,12,8,9,13,5,5,5,4,8,1,13,5,12
