14
1,6,3,6,1,7,5,5,5,5,7,6,3,4
3,14,10,10,3,13,5,5,5,5,13,14,9,6
10,10,10,10,11,7,7,6,2,2,3,12,3,12
10,11,14,9,12,8,8,11,13,13,15,7,13,6
10,10,9,5,7,5,5,14,3,6,10,10,1,14
10,9,5,5,13,7,4,9,14,11,14,8,3,12
11,5,5,7,4,10,3,6,8,8,11,5,13,6
11,4,1,13,7,12,9,14,3,5,12,3,6,10
11,6,2,3,13,5,5,15,13,5,4,10,11,14
10,10,11,14,1,5,5,15,5,4,2,10,10,8
10,10,10,10,3,5,5,15,5,4,10,10,9,6
10,11,14,10,11,7,5,13,6,2,10,10,3,12
10,11,14,11,14,9,5,4,9,15,14,9,13,6
9,12,8,8,9,5,5,5,5,12,9,5,5,12
