14
1,6,1,7,5,5,5,5,5,5,7,5,5,4
1,13,5,13,6,2,1,7,5,7,13,5,5,6
3,4,3,6,10,10,3,12,3,13,5,7,5,12
9,5,12,9,14,10,11,6,11,5,5,15,5,4
3,5,5,7,13,13,14,8,11,7,5,15,7,6
9,5,7,13,5,4,9,4,10,10,3,14,10,10
2,3,15,6,2,2,3,6,10,10,10,8,10,10
9,14,8,9,13,14,11,12,10,11,15,6,10,10
3,15,5,5,5,13,14,2,10,10,8,11,15,14
9,15,5,5,5,4,10,11,13,14,1,12,8,10
3,13,5,5,7,4,10,9,6,11,6,2,2,10
11,6,3,7,15,6,11,7,13,12,8,10,10,10
10,9,12,8,10,10,10,9,5,5,4,10,11,14
9,5,4,1,12,9,13,5,5,5,5,13,12,8
