14
1,7,5,5,5,5,7,7,6,3,6,2,2,2
3,14,1,7,5,7,13,12,11,14,10,11,14,10
10,8,3,13,7,13,5,5,12,10,10,10,10,10
11,7,15,5,15,5,5,5,5,14,9,14,11,14
10,10,9,7,13,5,5,5,6,10,2,10,10,8
11,14,3,13,5,5,5,5,14,9,13,13,15,4
10,11,13,5,7,4,3,6,11,5,7,7,14,2
10,10,3,7,13,6,11,12,11,6,8,10,10,10
8,9,12,11,4,11,13,5,12,9,4,8,11,12
2,3,6,10,3,15,7,6,3,5,7,6,9,6
10,10,11,15,14,10,8,9,14,3,12,10,1,14
11,14,8,8,8,11,5,6,10,11,4,10,3,12
10,11,5,5,4,11,4,10,10,9,4,9,13,6
8,9,5,5,4,9,4,8,9,5,5,5,5,12
