14
1,5,5,7,4,3,6,1,5,7,5,7,5,4
3,5,5,13,5,15,15,7,5,12,2,10,1,6
11,6,2,2,2,10,10,9,7,4,10,10,2,10
8,11,13,15,14,10,10,3,13,6,11,14,11,12
3,13,4,8,11,12,10,8,1,12,10,11,15,4
9,5,5,6,11,6,9,5,7,5,14,10,9,6
1,5,5,14,10,10,3,6,10,2,10,9,6,10
1,5,7,14,11,14,9,13,14,11,15,7,12,10
3,7,12,11,14,11,7,6,10,8,8,11,4,10
10,9,6,10,10,10,10,10,11,5,7,13,5,14
10,1,14,11,12,8,8,9,14,3,14,1,6,10
10,2,10,11,7,5,5,5,13,14,10,2,10,10
11,14,11,15,15,5,4,1,7,12,11,13,14,10
8,9,12,8,9,5,5,5,13,4,8,1,13,12
