14
1,5,5,7,5,5,7,5,5,5,5,5,7,4
2,2,3,12,3,5,13,5,5,7,5,5,13,4
10,10,11,5,14,1,6,2,1,15,5,4,1,6
11,14,9,4,10,3,13,15,7,13,5,5,5,12
8,10,1,5,13,15,4,10,11,7,5,5,5,4
3,13,7,5,5,13,4,9,15,13,7,5,5,4
11,7,15,6,2,2,3,6,10,3,15,5,5,6
10,10,11,15,14,10,11,12,11,14,11,4,2,10
10,10,10,10,10,11,14,1,14,10,9,6,10,10
10,8,10,10,11,14,9,7,12,11,7,14,10,10
10,1,14,10,10,10,2,10,2,10,10,11,14,10
10,1,14,9,12,11,12,11,12,8,8,8,9,12
10,1,15,5,5,13,6,11,5,5,5,7,5,4
9,5,13,5,5,5,13,13,5,5,5,13,5,4
