14
1,5,5,5,6,1,7,5,5,7,5,5,5,6
2,1,5,7,13,7,13,5,5,13,5,5,5,14
10,1,7,12,1,15,5,4,3,7,5,5,5,12
10,1,15,4,3,13,5,5,14,9,5,5,5,6
11,5,13,4,11,6,2,2,11,7,5,6,3,14
10,2,2,2,8,11,13,12,10,9,4,9,14,8
11,13,13,12,1,14,3,6,9,5,7,5,15,4
11,5,6,2,3,12,11,12,1,5,15,4,9,6
11,7,14,10,10,3,13,5,5,5,15,6,3,12
10,10,10,11,14,9,7,6,3,4,11,15,13,6
10,10,10,10,9,5,12,11,13,6,10,10,3,12
10,11,15,14,2,2,3,14,3,13,12,8,11,4
10,10,10,11,15,14,10,11,13,5,5,5,15,6
8,8,9,12,8,9,12,9,5,5,5,5,13,12
