14
1,7,5,5,5,5,7,7,4,2,1,7,5,6
3,13,5,5,5,6,10,10,2,9,5,15,4,8
10,3,5,7,7,14,10,11,12,1,5,15,5,4
9,14,3,14,10,10,10,11,5,5,5,15,5,6
1,12,10,8,10,10,10,11,5,5,5,13,7,12
3,5,13,4,10,11,13,13,5,7,5,6,11,4
10,3,5,6,11,14,3,6,1,14,1,12,11,6
10,10,1,13,14,10,9,14,1,15,5,4,10,10
11,12,1,7,13,12,3,15,5,13,5,4,10,10
10,3,6,11,7,4,9,15,5,5,5,7,14,10
10,10,11,14,9,6,1,13,7,5,4,11,13,14
11,12,10,10,3,13,5,5,13,7,5,13,4,8
10,2,10,9,13,7,5,5,5,15,5,5,5,6
9,12,9,5,5,13,5,5,5,13,5,5,4,8
