14
1,6,2,2,2,2,3,5,7,4,3,5,7,4
3,14,10,10,10,10,10,3,13,4,10,2,9,6
10,10,11,15,15,15,14,9,7,4,10,11,7,12
10,9,14,8,8,8,10,1,13,6,10,8,11,4
9,5,15,5,7,4,11,7,5,13,14,1,15,4
1,7,13,5,13,7,14,9,6,1,13,5,15,4
1,15,5,5,5,14,11,6,10,2,3,5,13,6
3,13,5,5,7,12,9,12,10,11,12,3,5,12
10,3,7,5,13,5,5,5,15,15,4,9,5,4
10,11,13,5,7,5,4,1,13,15,5,7,5,4
11,14,2,1,15,6,3,7,5,13,5,13,7,4
10,11,13,5,12,9,14,11,5,5,5,5,13,4
11,13,6,3,4,3,12,9,7,5,5,7,6,2
8,1,13,13,5,13,4,1,13,5,4,8,9,12
