14
1,5,7,5,4,1,5,5,7,7,5,5,5,6
2,2,10,2,2,1,7,5,13,14,3,5,7,12
11,15,14,11,15,7,13,5,4,9,14,1,15,4
8,10,11,12,9,13,5,5,5,7,12,3,13,4
2,11,15,5,5,5,7,5,7,13,5,13,5,4
10,11,15,5,5,7,15,5,15,5,5,5,5,6
10,10,10,3,5,14,11,6,9,7,6,1,6,10
11,14,10,9,6,10,9,12,3,12,11,6,10,10
10,10,10,3,12,9,7,4,9,4,10,11,15,14
8,10,8,10,3,5,13,7,7,5,12,10,10,10
1,15,4,11,12,1,7,15,15,7,4,10,10,10
1,15,4,11,4,1,12,10,8,9,4,10,10,10
2,11,7,15,5,5,5,13,7,5,4,11,14,10
9,12,8,9,5,5,5,5,13,5,5,12,8,8
