14
1,6,2,2,2,3,5,6,3,6,1,5,5,6
3,12,10,11,14,11,6,10,8,11,5,5,5,14
10,3,14,10,10,10,8,10,3,13,5,5,5,14
11,12,9,12,9,13,4,9,13,5,5,7,4,10
11,7,5,7,5,5,5,5,5,5,5,15,6,10
8,11,5,13,7,5,5,5,6,3,5,14,11,14
1,15,5,6,11,4,3,6,11,13,4,8,8,10
2,10,3,13,15,4,9,13,14,2,2,3,4,10
10,10,10,3,14,2,3,7,15,14,10,11,4,10
11,15,14,10,10,11,14,10,10,10,10,10,2,10
10,10,10,10,10,10,11,15,14,11,14,10,11,14
10,10,10,11,15,14,10,10,10,10,11,15,12,10
10,10,11,14,10,8,8,10,10,10,10,11,6,10
9,13,12,8,9,5,4,8,8,8,8,8,8,8
