14
1,7,4,2,2,3,6,3,6,3,6,2,2,2
3,14,3,14,10,10,9,14,10,10,9,15,14,10
10,10,10,10,10,8,1,14,10,10,1,14,11,14
8,9,14,10,11,7,5,12,10,10,3,12,10,10
3,7,12,9,12,9,5,6,9,12,9,6,8,8
8,9,5,7,5,7,5,13,6,2,2,11,6,2
3,4,3,14,2,10,3,6,11,13,13,12,11,14
9,7,14,9,13,13,13,12,10,3,6,3,14,10
3,13,15,5,4,1,7,5,12,8,11,14,10,10
10,1,15,5,5,7,13,5,4,1,12,10,8,8
10,2,11,6,3,15,5,5,5,5,6,11,5,4
10,9,14,9,13,13,5,5,5,5,14,9,7,4
10,3,15,7,7,5,5,7,5,5,15,5,14,2
8,8,8,8,9,5,5,13,5,5,12,1,13,12
