14
1,5,5,5,6,3,7,5,4,3,5,5,4,2
3,5,5,5,12,10,11,7,4,9,6,3,7,14
11,5,5,6,2,10,10,10,3,5,13,14,8,8
8,3,5,13,13,14,8,9,15,5,6,11,6,2
3,14,3,5,6,8,1,5,15,7,14,10,10,10
10,9,13,5,15,5,7,5,14,10,9,14,10,10
11,6,2,2,10,2,11,6,10,10,3,12,9,14
10,11,15,14,9,14,9,12,10,10,11,6,3,14
8,10,8,10,1,13,7,7,14,10,10,9,14,8
3,14,2,10,3,5,12,10,11,14,11,6,10,2
10,11,15,15,15,5,4,10,10,10,10,11,14,10
10,10,10,9,15,7,4,10,10,11,12,10,11,14
8,8,10,1,14,9,4,8,10,9,4,8,8,10
1,5,13,5,13,5,5,5,12,1,5,5,5,12
