14
1,5,5,7,5,7,5,5,5,6,1,5,5,6
2,3,7,15,7,13,6,3,5,13,7,7,6,10
11,12,10,10,10,1,14,9,7,4,10,8,9,12
10,2,10,10,10,3,13,5,13,4,11,5,7,6
10,10,11,14,10,11,4,3,7,5,13,5,14,8
10,10,10,10,8,11,4,8,11,6,2,3,13,6
10,10,10,10,1,14,3,6,10,10,10,9,6,8
11,13,13,13,5,14,11,12,10,11,15,5,15,6
11,5,5,7,5,14,11,7,12,8,8,1,12,8
11,7,5,13,4,9,14,10,2,2,1,7,5,4
10,10,1,7,7,5,14,10,11,12,1,15,7,6
10,10,1,14,8,3,14,11,13,4,3,14,10,10
10,10,2,10,2,10,11,15,5,7,12,8,10,8
8,9,13,13,12,8,8,9,4,8,1,5,13,4
