14
1,6,1,7,4,3,5,5,5,5,7,5,7,6
3,12,3,13,6,11,4,3,7,5,13,5,12,10
10,2,10,3,13,15,4,11,13,7,5,7,5,14
9,15,14,9,4,11,4,10,1,15,4,9,4,10
3,12,11,7,6,9,5,15,7,13,5,5,5,14
9,5,12,10,9,7,5,15,13,5,7,7,7,14
3,5,5,15,7,14,3,14,3,5,12,8,10,8
11,4,1,14,8,10,9,12,11,5,5,5,13,6
11,6,3,15,6,10,3,7,15,7,5,7,5,14
11,15,14,10,10,10,10,10,10,8,1,13,6,8
10,10,11,14,11,13,14,10,11,4,2,1,14,2
10,10,10,11,14,3,12,8,9,5,15,5,13,12
10,10,10,10,10,9,5,5,7,5,13,5,7,4
8,8,8,8,8,1,5,5,13,5,5,5,13,4
