14
1,7,5,5,7,5,5,5,5,5,5,5,5,6
1,13,5,6,9,5,7,5,5,5,5,5,7,12
1,5,5,14,3,7,13,5,5,5,7,5,13,4
1,5,5,14,10,11,5,6,3,7,14,2,2,2
1,7,6,10,10,10,1,15,12,10,10,11,14,10
3,14,11,12,11,12,1,13,6,8,9,14,9,12
10,10,10,2,11,6,3,7,14,3,5,13,5,4
11,15,15,14,10,10,9,12,11,13,7,5,5,6
10,10,10,11,15,15,5,5,12,1,15,7,4,10
10,8,10,8,8,9,7,6,3,6,10,10,3,14
10,3,14,2,2,3,12,11,14,10,11,14,10,10
11,14,10,10,10,9,6,10,8,11,12,10,10,10
10,8,9,13,13,5,12,9,6,10,2,9,14,10
9,5,5,5,5,5,5,5,13,13,12,1,12,8
