14
1,7,7,7,7,7,5,5,6,3,6,2,2,2
2,10,11,14,10,9,7,4,10,10,11,14,10,10
10,10,10,10,10,1,13,6,10,10,8,11,14,10
11,14,10,11,15,5,7,12,11,12,1,12,11,12
10,11,14,10,10,3,14,2,11,5,5,5,15,4
11,14,8,8,8,10,9,13,14,3,5,5,13,4
10,10,2,2,1,14,3,6,10,9,5,7,5,6
10,10,11,13,5,12,11,12,10,3,5,13,4,10
10,11,15,5,5,5,13,5,14,9,5,7,4,10
10,10,11,4,2,2,3,7,13,5,5,13,7,14
10,10,10,2,11,14,11,13,7,5,5,5,12,10
9,15,13,12,10,11,15,5,15,5,5,5,4,8
2,10,3,7,14,8,9,6,9,7,5,5,5,4
9,13,12,8,8,1,5,13,5,13,5,5,5,4
