14
1,7,5,5,5,5,5,7,6,3,6,3,6,2
3,13,5,7,5,4,1,12,10,10,11,14,11,14
9,5,5,13,7,6,1,6,11,12,8,8,10,8
3,7,6,2,10,10,3,15,13,7,5,5,15,6
8,10,9,13,15,14,10,10,3,15,5,4,10,8
1,15,4,3,12,11,12,8,8,9,7,4,11,6
2,11,7,14,2,10,3,6,3,6,11,4,11,14
10,8,10,11,12,10,9,14,10,10,11,4,10,10
10,3,12,11,6,10,1,14,10,10,11,7,14,10
11,13,4,10,10,9,5,13,14,9,14,9,14,10
10,2,3,14,10,1,5,7,13,4,10,1,12,8
11,14,10,10,11,5,5,13,7,4,11,4,2,2
10,11,14,11,15,5,5,5,15,4,11,6,10,10
8,8,8,8,9,5,5,5,13,5,12,9,13,12
