14
1,7,5,7,5,5,5,5,6,3,7,7,6,2
3,14,3,13,5,5,5,6,10,10,10,10,10,10
10,10,11,7,5,5,5,12,10,11,14,10,11,14
10,10,11,13,7,5,5,4,11,14,11,14,10,10
8,9,15,5,13,7,5,5,14,8,10,10,10,10
2,3,13,4,3,15,5,4,10,3,14,11,14,10
11,13,7,5,14,10,3,6,11,12,8,9,12,10
10,3,13,6,8,11,13,12,9,5,7,6,3,14
10,10,3,12,2,11,7,5,6,2,10,10,10,10
10,10,10,2,9,14,9,4,10,11,14,10,10,10
10,11,14,9,5,13,7,4,11,12,10,11,14,10
10,10,11,5,7,7,15,5,15,7,12,8,10,8
10,8,10,1,12,8,11,4,10,10,3,6,10,2
9,5,13,5,5,5,13,4,8,8,8,9,13,12
