14
1,7,5,5,5,5,6,3,5,5,7,5,5,6
3,15,5,5,7,5,12,11,5,5,13,5,7,14
10,11,5,5,13,5,6,10,3,5,5,7,13,12
8,11,5,5,5,7,15,14,10,1,5,14,3,6
1,13,5,7,5,14,8,10,9,5,5,15,12,10
1,5,5,13,6,11,5,12,3,5,5,15,5,12
3,5,5,7,13,12,3,6,11,7,5,13,5,4
11,5,6,11,7,6,9,13,14,9,7,5,5,4
10,2,10,10,10,11,4,2,11,5,13,5,5,6
10,11,13,14,11,14,3,14,10,1,5,5,5,14
10,11,4,11,14,11,14,10,10,3,5,6,3,14
10,9,6,10,10,10,8,9,15,13,4,11,14,10
10,3,13,14,10,9,5,5,13,5,7,12,10,10
8,8,1,13,12,1,5,5,5,5,13,4,8,8
