14
1,7,7,7,5,5,5,5,6,2,3,7,5,6
2,10,11,13,7,7,5,5,13,13,12,9,6,10
11,14,10,3,15,15,5,5,5,4,1,7,14,10
10,11,15,15,14,9,5,5,7,4,3,12,8,10
10,10,10,10,10,1,5,5,13,6,11,6,3,12
10,8,8,10,11,7,5,7,7,14,8,10,11,6
11,7,7,14,10,10,3,14,10,10,3,15,14,10
10,10,10,8,10,8,9,12,11,15,14,10,10,10
10,10,10,3,13,4,2,2,10,10,8,11,12,10
11,14,10,10,2,3,15,15,14,11,6,11,6,10
10,10,10,11,15,14,8,8,10,8,8,8,11,14
10,8,9,12,8,11,5,5,15,5,5,7,12,8
11,5,5,5,7,15,5,5,13,5,5,13,5,4
9,5,5,5,13,13,5,5,5,5,5,5,5,4
