14
1,7,7,7,7,6,2,1,6,2,2,1,5,6
2,10,10,10,10,10,10,3,13,14,10,3,6,10
10,10,10,10,10,10,10,11,4,10,10,8,10,10
10,11,15,14,10,9,13,13,6,9,14,2,11,14
10,10,10,10,10,3,5,7,13,5,13,13,14,10
9,14,8,9,13,15,5,13,7,5,5,5,12,10
1,13,5,7,5,15,7,6,10,3,5,6,3,14
1,5,7,13,6,10,9,12,9,12,3,13,12,10
3,7,13,4,8,11,4,3,5,5,15,5,5,12
10,10,1,7,5,13,4,11,5,4,10,2,2,2
10,10,1,13,5,5,6,10,3,6,11,13,14,10
10,11,5,7,5,5,13,14,10,11,14,3,13,14
11,14,1,13,7,5,4,10,10,8,8,9,6,8
8,8,1,5,13,5,5,13,13,5,5,5,13,4
