14
1,7,5,5,7,7,5,5,7,5,5,5,5,6
2,11,5,6,11,15,7,5,13,5,5,6,1,14
10,9,6,9,14,9,13,5,5,5,6,10,2,10
11,5,14,2,10,3,7,5,5,5,14,10,11,14
10,1,14,11,14,10,10,1,5,5,12,10,10,10
10,1,14,8,8,9,13,5,6,2,2,9,14,10
11,5,13,7,5,4,3,6,11,15,15,7,12,10
9,7,5,13,5,6,9,14,10,10,10,10,2,10
2,11,6,3,6,10,3,13,12,10,11,15,15,14
10,10,10,10,10,10,9,6,3,14,8,10,8,10
11,14,11,14,10,11,5,13,14,11,4,10,2,10
10,9,14,8,9,13,5,6,10,9,5,13,13,14
11,4,9,7,4,1,7,12,11,7,5,5,5,12
9,4,1,13,5,5,13,4,9,13,5,5,5,4
