14
1,6,1,7,5,5,5,6,3,5,4,2,2,2
1,14,3,13,7,5,4,9,13,5,6,9,15,12
1,14,11,5,13,5,5,6,1,5,14,1,15,4
3,15,13,7,6,1,5,14,2,2,10,3,15,6
10,8,1,12,9,7,5,14,10,10,11,12,10,10
10,1,5,5,6,11,5,13,14,11,14,3,12,8
10,3,5,5,12,10,3,6,11,14,11,14,3,6
10,11,5,5,5,14,9,14,10,10,8,11,14,8
10,9,5,5,6,11,5,13,14,9,4,10,11,6
11,7,5,5,12,9,5,7,15,6,2,8,11,14
10,9,7,7,7,4,3,12,10,8,9,5,14,10
11,5,12,8,11,5,15,4,9,7,5,5,14,10
11,6,2,3,13,5,15,7,6,11,7,7,12,10
8,9,13,13,5,4,8,8,9,12,8,9,4,8
