14
1,7,5,6,1,5,5,5,6,1,5,7,6,2
2,9,7,15,7,7,7,5,14,1,5,14,10,10
11,5,14,10,8,10,9,4,11,5,5,15,14,10
8,1,14,10,3,14,2,3,15,5,7,14,11,14
2,1,14,10,8,9,15,12,8,3,12,10,10,8
9,5,14,9,7,5,13,5,6,10,2,10,11,4
1,7,12,3,13,4,3,6,8,9,12,10,11,6
3,13,5,13,7,5,13,12,3,6,3,14,8,10
11,5,7,5,13,5,6,1,14,9,12,11,5,12
10,3,13,5,5,5,15,7,12,1,7,13,5,4
10,9,7,5,5,5,14,9,6,3,13,4,2,2
10,1,14,1,7,5,12,2,11,15,7,5,15,14
11,5,14,1,13,5,4,11,12,8,9,4,10,8
8,1,13,5,5,5,5,13,5,5,5,5,13,4
