14
1,6,1,7,5,5,5,5,7,5,5,7,5,4
3,14,3,15,5,5,5,5,13,5,7,13,5,4
10,10,10,11,5,5,6,1,5,5,13,5,5,6
11,14,10,11,5,5,13,5,7,5,5,5,5,14
10,11,14,11,5,5,5,7,13,5,5,5,7,14
10,11,13,13,7,5,4,9,7,5,5,7,13,12
10,9,4,1,15,4,3,7,15,5,5,13,5,6
10,3,5,7,13,4,9,12,11,7,4,2,2,10
10,11,7,15,5,5,5,5,12,11,7,13,14,10
10,10,10,11,5,5,5,5,6,8,10,1,13,14
10,10,10,10,2,2,1,5,14,1,15,7,4,10
11,13,14,11,14,10,3,5,13,5,14,11,4,10
11,6,10,10,11,15,13,7,6,1,12,9,5,14
8,8,8,8,8,8,1,12,9,5,5,5,5,12
