14
1,7,7,5,7,7,6,3,5,5,4,1,7,6
3,14,10,1,15,14,10,11,5,5,7,5,12,10
8,8,10,2,10,10,11,15,5,5,13,5,6,10
2,2,10,10,10,10,10,11,5,5,5,7,13,14
11,14,11,14,10,11,14,9,5,5,7,13,6,10
10,10,10,9,14,10,9,7,7,5,13,5,14,8
10,10,10,3,13,12,3,14,9,5,7,7,13,4
10,9,12,9,5,6,9,12,3,5,13,13,5,6
10,3,7,5,7,14,3,7,14,3,5,7,5,12
11,14,10,1,14,10,10,11,14,10,1,15,5,4
11,14,10,3,12,11,14,10,10,11,5,13,5,6
10,10,10,10,3,15,14,10,10,10,2,2,3,14
10,10,10,10,10,10,10,10,11,14,10,9,14,8
8,9,13,13,12,8,8,8,9,12,9,5,13,4
