14
1,7,5,5,7,5,5,7,5,5,5,5,7,4
2,11,5,7,14,2,3,15,5,5,6,1,14,2
10,11,4,10,9,13,12,9,6,1,15,5,13,12
11,15,6,9,5,5,5,5,13,5,13,7,5,4
8,9,15,7,5,7,5,7,5,5,4,11,7,4
3,6,10,10,2,11,5,13,7,7,5,14,11,6
8,9,14,10,9,15,7,6,10,9,4,8,8,10
3,5,15,14,3,14,9,12,11,7,5,6,2,10
9,6,10,10,10,10,3,7,15,15,6,10,10,10
2,10,10,10,10,11,14,10,10,10,10,9,14,10
11,12,11,15,12,10,10,10,10,11,13,6,11,14
11,5,14,11,5,14,10,10,10,10,2,10,8,10
10,2,11,13,6,8,8,8,10,10,9,15,5,12
9,13,13,5,13,5,5,5,12,8,1,13,5,4
