14
1,5,5,7,5,4,3,7,6,1,6,3,6,2
2,3,7,15,5,6,10,10,9,5,13,12,9,14
11,12,10,9,6,11,14,11,7,5,7,5,5,12
11,7,14,2,10,10,9,12,11,5,13,7,5,4
10,10,10,9,14,11,5,5,13,7,4,11,7,4
10,10,11,5,15,15,5,5,6,11,4,10,9,4
8,8,10,3,14,10,3,7,14,11,7,15,5,4
1,7,12,10,10,10,9,12,10,10,11,13,7,6
1,15,4,10,11,14,3,6,10,10,10,3,14,10
3,13,5,14,8,9,14,9,13,14,10,10,11,14
11,5,4,11,6,1,13,6,3,14,10,10,10,10
10,3,6,8,11,5,5,14,10,11,12,8,10,10
10,8,10,3,12,1,7,12,10,9,7,4,10,10
9,5,13,13,5,5,13,5,12,1,13,5,13,12
