14
1,7,5,5,7,5,7,7,6,2,2,1,7,4
3,13,4,3,13,5,14,10,10,11,14,1,15,4
9,5,5,15,5,4,10,10,11,12,9,5,15,4
3,5,7,13,5,4,10,10,11,5,6,2,11,6
9,7,13,5,7,4,10,10,10,2,10,11,14,10
3,13,7,5,13,4,9,13,15,14,10,10,10,10
11,5,13,5,7,5,7,6,10,10,10,10,10,10
9,5,7,5,13,6,9,12,10,11,15,15,14,10
1,5,13,6,1,15,5,5,12,8,8,8,10,10
1,7,5,12,2,9,6,3,5,5,5,5,13,14
2,11,4,2,11,5,13,13,7,5,5,5,7,12
10,9,7,12,10,1,5,5,13,6,2,1,15,4
11,5,15,7,15,5,5,7,7,15,15,7,13,4
8,1,12,9,12,1,5,12,8,8,8,9,5,4
