14
1,6,3,5,6,2,3,7,5,5,5,7,5,4
1,13,14,1,13,15,12,8,3,5,5,13,7,4
3,5,12,1,7,14,2,2,9,5,5,7,15,4
10,3,6,3,14,11,14,10,1,7,7,12,11,4
11,12,8,10,10,10,11,15,6,10,11,6,11,6
11,5,5,12,8,10,8,8,11,12,11,14,8,10
11,5,5,7,5,14,3,6,11,4,10,11,7,14
11,6,2,10,2,10,9,14,11,6,10,10,10,10
10,11,14,10,10,11,5,15,12,11,14,8,10,10
10,10,10,11,14,11,6,11,6,11,12,2,10,10
10,10,11,14,11,14,9,14,9,14,3,14,10,10
10,8,8,8,8,10,2,9,6,10,10,11,15,14
11,7,5,5,7,13,12,1,14,9,12,8,10,10
8,9,5,5,13,5,4,1,13,5,5,5,12,8
