14
1,7,7,6,1,7,7,5,7,5,5,5,5,6
1,14,10,8,1,14,11,4,9,5,7,6,3,14
1,14,11,7,6,10,9,6,1,5,12,9,14,10
3,14,10,10,10,10,3,12,2,2,3,5,15,12
10,8,8,8,9,14,11,6,10,11,14,1,13,6
10,2,3,7,7,14,8,8,9,12,10,1,5,14
11,13,12,8,8,10,3,7,7,5,13,5,5,14
9,6,3,6,3,14,9,12,9,7,5,7,5,12
1,15,14,10,10,11,6,3,5,14,2,11,7,4
1,14,10,10,10,10,10,10,3,13,13,12,9,6
3,15,14,11,14,10,10,10,9,6,3,7,7,14
8,10,10,8,10,10,9,14,1,15,12,8,8,10
3,12,10,1,13,14,3,14,3,13,5,5,5,14
9,4,8,1,5,13,12,9,13,5,5,5,5,12
