14
1,7,5,7,5,5,5,5,5,7,5,5,5,6
3,14,1,14,2,3,5,5,5,15,5,7,6,10
11,15,7,15,14,11,5,5,5,15,5,14,10,10
10,10,8,10,11,13,7,6,1,15,5,12,9,14
10,10,3,12,8,3,12,11,5,13,6,1,5,14
10,10,9,6,1,13,4,8,2,3,14,3,5,14
10,8,3,13,5,4,3,6,9,14,11,12,3,12
10,1,13,7,5,7,13,12,3,12,8,3,13,6
10,3,5,13,6,11,6,3,15,5,6,10,2,10
11,13,5,4,10,10,9,14,10,1,15,15,15,14
10,1,5,7,13,14,2,10,10,1,14,8,10,10
8,1,7,13,4,10,10,10,11,6,10,2,10,10
2,3,15,5,4,9,12,10,10,11,15,14,11,14
9,13,13,5,5,5,5,13,12,8,8,9,12,8
