14
1,5,5,5,6,2,1,7,5,5,4,2,2,2
1,5,5,7,13,13,5,13,7,5,7,15,14,10
3,6,1,13,6,1,5,5,14,2,8,8,9,14
10,11,5,7,12,3,7,6,11,15,6,1,7,12
11,14,3,13,7,12,8,9,14,8,10,1,14,2
10,10,10,3,12,3,5,7,15,6,11,5,14,10
10,10,8,9,6,10,3,14,10,8,8,3,13,12
11,14,3,6,11,14,9,12,9,5,6,10,2,2
10,11,14,10,10,11,7,5,7,5,13,15,13,12
10,10,10,9,12,10,9,4,11,5,5,13,5,6
10,10,10,3,5,14,1,7,13,7,5,5,5,12
8,10,11,14,2,10,1,13,7,15,5,5,5,4
3,13,14,10,10,10,1,7,13,12,2,2,3,6
9,4,8,9,13,13,5,13,5,5,13,13,12,8
