14
1,6,2,2,2,1,7,5,5,5,7,4,1,6
2,10,10,10,9,7,13,5,5,7,13,5,7,14
10,11,14,10,3,14,2,2,2,9,7,4,10,8
9,12,9,15,12,10,10,11,15,7,13,4,9,6
1,5,5,13,6,10,10,10,8,9,7,4,1,14
1,5,7,7,13,13,15,13,6,2,11,7,6,10
3,7,13,13,5,4,11,6,10,10,10,8,10,10
11,13,5,5,7,4,9,12,10,11,15,6,10,10
9,5,7,5,13,7,6,2,10,10,10,11,15,14
1,7,14,1,6,10,8,10,11,14,10,10,8,10
3,14,10,2,11,13,6,11,14,10,10,9,5,14
8,8,11,14,10,1,14,8,8,10,9,5,7,12
2,2,10,10,10,3,13,5,7,13,5,5,15,4
9,13,12,9,12,9,5,5,13,5,5,5,13,4
