14
1,5,7,5,5,5,6,3,5,5,5,7,5,4
3,5,13,5,5,5,14,9,7,5,5,13,5,4
11,5,5,5,5,7,13,7,13,7,5,5,5,6
9,6,3,6,2,10,2,10,3,14,1,7,5,12
3,13,12,8,10,11,14,11,14,10,3,15,6,2
11,5,7,6,11,14,9,12,10,10,10,10,11,14
10,3,14,11,14,8,3,6,10,10,8,8,10,10
10,8,8,8,11,4,9,14,10,11,6,2,11,14
11,7,6,3,15,5,5,13,13,13,13,14,10,10
10,10,11,14,9,5,5,7,4,1,7,13,14,10
10,10,10,11,6,2,3,13,4,2,11,5,14,8
10,10,10,10,9,13,13,5,5,13,15,4,10,2
11,14,10,9,7,5,5,5,5,5,13,4,10,10
8,9,13,5,13,5,5,5,5,5,5,4,9,12
