14
1,6,2,3,5,5,7,5,5,5,5,5,7,4
3,15,14,10,1,7,12,3,7,5,5,7,13,4
10,10,11,14,3,14,3,14,11,6,2,11,6,2
10,10,10,10,8,9,14,10,8,11,14,10,10,10
10,8,8,8,3,5,14,8,1,12,11,12,11,12
11,6,1,5,13,7,12,3,7,5,13,6,9,6
10,11,6,1,6,10,3,14,9,6,3,13,7,12
10,8,11,5,13,14,9,12,3,13,15,4,11,6
9,4,10,1,7,13,5,7,13,4,11,6,8,10
3,4,10,2,10,2,3,15,6,2,10,11,5,12
11,7,14,10,10,9,14,8,9,12,10,10,2,2
10,10,10,10,11,5,15,5,5,7,12,11,14,10
10,10,11,13,14,1,14,1,7,13,4,10,10,10
8,8,9,5,13,5,13,5,13,5,5,12,9,12
