14
1,7,5,5,5,7,5,5,5,5,5,6,3,4
3,15,5,5,5,13,5,5,7,5,7,13,13,6
11,13,5,5,7,5,6,2,10,2,11,4,3,12
11,7,7,4,10,2,10,10,10,10,11,4,9,6
11,14,11,7,15,14,11,15,14,10,10,2,3,12
10,10,8,10,10,10,8,8,11,13,13,13,13,6
10,10,3,14,8,8,3,6,9,7,6,2,3,14
10,11,15,15,7,7,13,12,3,12,9,13,12,8
10,10,10,10,8,11,6,3,14,3,5,7,7,6
11,13,12,10,1,14,10,10,11,12,1,14,8,8
9,6,2,10,2,10,10,10,9,7,4,10,2,2
1,13,14,10,11,14,11,15,7,13,5,14,11,12
3,5,13,12,10,11,14,10,11,5,6,9,13,4
9,5,5,5,12,8,8,8,9,5,13,5,5,4
