14
1,6,2,3,6,2,3,5,5,5,7,7,4,2
2,10,9,14,11,15,13,4,3,5,12,10,2,10
9,13,5,14,8,9,7,5,13,7,6,10,11,14
1,5,5,15,5,5,13,6,1,12,10,11,12,10
1,7,7,13,5,7,5,13,7,4,10,11,6,10
3,12,9,5,7,13,5,5,14,2,11,14,9,14
10,2,3,5,15,4,3,6,10,10,10,11,5,14
10,10,10,1,13,6,9,13,13,13,12,10,1,14
11,15,14,1,7,13,7,7,7,5,5,12,2,10
8,10,10,1,15,4,10,10,9,7,6,2,9,14
3,12,10,1,13,6,10,11,5,14,11,14,2,10
9,7,12,1,7,12,8,10,3,12,10,10,11,14
1,13,7,4,9,7,5,14,9,6,10,11,14,10
1,5,13,5,5,13,4,8,1,12,8,8,8,8
