16
1,5,7,5,4,3,7,5,6,3,5,7,5,5,4,2
3,7,14,1,6,10,11,6,9,13,5,13,5,7,6,10
10,10,9,5,12,10,10,10,1,5,7,5,5,12,11,14
10,9,7,5,5,12,10,9,5,7,13,5,5,5,12,8
10,2,10,1,7,4,10,1,7,13,5,7,5,5,5,4
10,10,9,7,13,6,11,5,15,7,5,13,5,5,5,4
10,10,2,10,3,13,14,1,13,14,3,5,7,6,3,6
10,11,13,15,14,3,15,7,6,10,10,1,14,10,10,10
11,14,1,15,14,8,10,9,12,11,14,2,10,9,12,10
10,11,6,10,10,2,10,2,2,11,14,11,13,6,3,12
10,10,10,10,10,11,15,14,11,14,10,11,6,9,13,6
10,10,10,10,9,14,8,10,10,10,11,15,14,1,5,12
11,14,10,10,3,13,4,10,10,10,9,14,9,5,5,6
8,10,9,14,11,5,4,9,14,8,1,12,2,2,2,10
3,13,5,15,13,5,5,5,13,5,5,6,11,15,14,10
9,5,5,13,5,5,5,5,5,5,5,12,8,8,9,12
