16
1,5,7,5,5,5,4,3,4,2,1,7,7,5,7,4
3,7,13,5,5,5,7,13,5,14,1,14,8,1,13,6
10,10,3,7,5,5,13,5,5,14,3,13,5,5,5,12
10,11,14,11,7,5,5,7,5,13,13,7,6,3,6,2
10,10,11,14,11,5,5,13,5,6,1,12,9,12,11,14
10,10,10,10,11,5,4,1,5,14,3,7,5,5,13,12
11,14,10,10,9,5,7,5,5,14,10,11,7,4,1,6
11,13,12,11,7,7,14,3,6,11,12,11,15,6,1,14
11,5,7,12,8,8,8,9,13,15,4,10,10,10,3,14
10,1,15,5,7,5,5,4,3,13,5,14,10,11,14,10
10,3,14,2,11,7,5,5,13,5,6,10,8,8,10,8
10,10,10,11,15,13,7,5,5,5,12,10,3,5,13,4
11,14,10,10,9,7,13,5,7,5,4,10,9,6,3,6
8,10,11,14,3,13,5,5,13,7,5,14,1,15,12,8
2,11,14,10,11,6,3,7,5,13,4,10,1,13,7,4
9,12,9,12,8,9,12,9,5,5,4,9,5,5,13,4
