16
1,7,6,3,5,7,5,5,5,7,5,7,7,6,2,2
1,14,10,10,3,15,5,5,5,14,1,14,8,9,13,12
3,14,11,12,10,9,5,4,1,15,5,13,5,5,7,6
11,14,11,5,13,5,7,5,5,15,5,5,5,5,14,10
10,11,15,5,5,5,15,5,5,13,5,5,5,5,15,14
10,10,9,7,7,7,13,5,5,4,1,7,5,7,13,12
10,10,1,12,9,15,7,5,5,6,3,15,6,9,5,6
10,11,4,2,3,12,10,3,6,11,14,11,14,1,7,12
9,13,7,14,9,7,14,9,14,10,10,10,10,3,15,6
2,2,10,11,5,12,11,4,9,14,10,10,10,10,10,10
11,13,15,15,6,2,11,7,5,15,14,10,9,14,8,10
10,2,10,10,10,10,10,10,2,9,15,14,1,13,4,10
10,10,10,11,15,14,10,10,10,3,15,13,5,6,2,10
11,14,11,14,11,15,14,10,11,12,8,1,5,14,10,10
10,10,10,10,10,10,10,9,13,5,7,7,7,13,14,10
8,9,12,8,8,8,9,5,5,5,12,8,8,1,13,12
