16
1,5,5,5,7,5,5,7,5,5,5,7,5,5,5,4
3,5,5,7,13,5,6,10,1,7,7,15,5,5,5,4
9,5,7,13,5,7,14,10,2,10,10,10,3,6,2,2
3,5,14,3,5,12,10,10,10,11,13,14,10,10,10,10
8,3,13,12,1,5,13,14,11,12,3,13,14,10,10,10
3,13,5,6,1,7,4,9,13,6,11,4,11,14,11,14
10,2,2,10,3,14,2,1,5,14,9,6,10,11,14,10
11,14,10,10,10,10,10,3,6,10,3,14,10,11,13,14
10,9,14,10,10,10,11,13,12,11,12,9,14,9,6,10
9,6,9,15,14,11,14,2,2,10,2,2,10,3,14,10
1,12,1,15,12,10,11,14,11,14,11,14,9,14,8,10
2,2,2,11,4,10,10,10,10,10,10,10,1,15,4,10
10,10,11,15,5,15,14,11,12,9,12,8,1,13,5,14
10,11,12,9,5,15,12,11,5,5,7,5,5,6,3,12
11,14,1,5,7,13,7,13,7,5,13,4,2,10,9,6
8,8,1,5,13,4,9,5,13,5,5,5,13,13,5,12
