16
1,7,6,2,1,7,7,7,7,5,5,5,7,5,5,4
1,14,10,10,3,14,11,14,11,7,4,3,13,6,3,6
1,14,9,15,14,10,10,10,10,10,2,10,3,15,14,10
3,12,3,12,10,10,10,10,10,11,12,10,10,8,8,10
9,6,9,4,11,14,10,11,15,14,3,14,8,3,6,10
3,14,2,2,10,11,14,10,10,11,12,11,7,14,9,12
10,8,11,15,14,10,10,10,8,11,4,10,10,10,3,6
9,5,12,10,11,13,14,11,6,9,7,12,8,9,14,8
1,7,6,10,11,4,10,9,12,1,15,5,5,5,15,4
3,12,10,11,13,6,9,7,5,5,15,5,5,4,9,6
11,5,14,9,6,10,3,13,6,2,11,5,5,5,5,14
11,6,10,3,12,10,10,3,12,11,13,5,5,6,3,12
10,8,11,13,6,10,10,11,4,10,1,6,3,14,11,4
10,2,9,7,13,15,14,9,6,10,3,13,12,9,13,6
10,9,5,13,6,10,8,3,15,12,11,5,5,5,7,12
9,5,5,5,13,13,5,12,9,5,13,5,5,5,13,4
