16
1,5,7,6,2,3,5,5,7,5,5,7,5,4,2,2
3,5,12,11,14,11,7,7,15,5,7,13,5,4,11,14
10,3,4,8,11,12,8,8,10,1,15,6,3,7,14,10
9,15,5,5,15,5,5,6,10,1,12,9,12,10,10,10
2,10,2,2,11,7,6,10,10,1,5,5,7,12,8,10
10,10,10,10,11,14,10,10,11,7,5,5,13,6,3,12
11,14,10,10,10,10,10,9,12,8,3,5,5,12,9,6
10,11,15,13,14,10,10,3,6,3,13,5,5,7,5,14
10,10,9,7,14,10,10,11,12,9,7,5,5,13,7,14
11,15,7,14,10,11,15,13,6,2,9,7,5,7,12,8
10,10,8,10,11,15,13,4,9,15,5,14,2,11,7,6
10,10,3,12,10,11,7,7,5,13,5,13,13,12,10,8
10,9,13,5,14,10,11,13,6,3,5,4,1,7,13,4
8,3,5,5,12,10,9,6,11,15,7,5,5,13,7,4
1,13,5,5,6,10,3,14,10,10,8,1,7,7,13,4
1,5,5,5,13,12,8,8,8,9,5,5,12,9,5,4
