16
1,5,6,3,7,5,7,7,6,2,3,7,7,7,4,2
2,2,10,10,8,1,12,8,11,13,12,10,10,11,7,14
11,13,13,13,5,6,2,3,14,2,3,12,8,8,8,10
11,7,5,6,3,12,11,14,11,14,10,2,3,7,7,14
8,10,1,15,13,5,12,8,10,11,14,9,14,8,8,8
1,13,5,13,7,5,5,6,8,8,10,3,13,5,5,4
1,7,5,7,13,7,7,13,5,7,15,13,5,7,5,4
3,14,2,11,5,14,10,3,6,10,8,3,5,13,5,4
10,9,12,9,6,10,10,9,13,13,5,15,5,5,5,4
10,2,2,2,10,11,14,2,2,1,7,13,5,5,5,6
11,15,14,11,14,10,11,14,10,3,14,3,7,5,7,12
8,10,10,10,10,8,10,10,10,10,9,14,8,1,15,4
2,10,10,10,11,6,8,10,10,10,1,15,4,1,13,6
11,14,11,14,10,10,1,15,13,14,3,15,7,5,7,12
10,10,10,11,12,11,6,11,4,10,10,8,10,3,15,6
8,8,9,13,4,8,9,13,5,13,13,4,8,8,8,8
