16
1,6,1,7,5,7,5,5,5,7,5,7,7,5,6,2
2,11,5,13,4,11,5,7,6,9,6,10,11,4,10,10
10,9,7,5,6,10,3,14,11,7,12,10,11,4,11,14
9,7,13,6,11,15,14,8,10,11,4,10,11,6,10,10
3,13,5,14,10,8,11,4,8,9,6,11,14,10,10,10
9,5,6,11,13,5,13,5,7,6,11,14,10,11,14,10
3,5,12,10,2,1,7,5,13,14,9,14,10,10,11,14
11,5,4,10,10,1,14,3,6,11,7,15,14,10,10,10
11,5,4,9,13,7,13,13,12,8,8,9,15,12,10,8
11,6,3,7,5,13,5,5,7,5,5,7,13,4,10,2
10,9,13,13,5,7,5,5,12,3,5,13,5,7,13,12
9,7,6,1,5,15,5,5,6,11,5,4,2,9,5,6
3,12,10,3,5,13,5,7,13,15,5,5,13,5,5,14
11,6,11,15,7,7,5,13,7,13,7,4,2,2,1,14
10,10,8,8,10,9,5,6,9,6,9,7,15,15,7,12
8,8,1,5,13,5,5,13,5,13,5,12,8,8,9,4
