16
1,7,7,5,5,5,5,5,5,7,7,5,7,5,5,4
3,12,11,5,5,7,5,4,3,15,12,3,13,5,5,4
10,3,14,2,2,11,7,4,10,10,2,9,5,5,7,4
11,12,9,14,10,10,9,7,14,11,14,3,5,5,13,4
10,2,2,11,14,10,3,14,10,8,11,15,6,2,3,6
11,15,14,10,11,14,8,8,8,3,12,10,11,13,12,10
8,8,10,8,8,11,7,5,5,13,5,12,11,5,7,14
2,2,10,2,3,13,14,3,6,1,6,3,15,5,14,10
11,13,13,13,14,1,15,13,12,3,14,10,11,6,10,10
9,7,5,4,10,3,13,5,5,12,11,14,10,10,10,10
3,15,7,6,10,9,5,6,2,3,15,14,10,10,10,10
10,10,11,15,15,5,7,12,11,14,10,10,10,11,14,10
11,15,14,10,10,1,13,5,14,8,10,10,10,8,10,10
10,10,10,11,12,1,7,5,13,5,14,11,13,5,14,10
10,10,10,9,6,1,13,7,5,7,12,9,7,5,13,12
8,8,8,1,12,1,5,12,1,13,5,5,13,5,5,4
