16
1,7,5,5,5,5,6,2,3,6,3,5,5,4,3,6
1,13,5,5,5,7,13,14,10,10,11,5,5,4,10,8
1,5,5,7,5,14,2,10,10,10,11,6,2,2,11,6
2,3,5,13,5,13,12,9,14,11,14,11,15,14,10,10
11,15,7,7,6,1,5,7,12,10,10,10,10,10,10,10
10,10,11,15,14,3,7,13,7,14,10,10,8,9,12,10
10,10,10,10,10,10,10,1,12,10,9,14,2,2,2,10
10,10,10,10,10,10,10,3,6,11,6,10,10,11,15,14
11,15,14,10,11,14,10,9,13,15,14,11,15,14,8,8
10,10,8,8,10,11,15,4,3,12,9,14,8,9,5,4
11,15,4,3,13,12,11,5,13,6,2,11,5,7,5,6
10,11,5,15,5,5,13,7,4,10,11,14,1,13,4,10
11,13,5,15,5,5,6,9,5,12,8,10,1,6,2,10
10,1,7,13,5,5,15,4,2,3,5,14,1,14,11,14
10,3,15,5,5,5,13,5,13,15,4,9,6,10,10,8
8,9,13,5,5,5,5,5,5,13,5,4,9,13,13,4
