16
1,7,5,5,7,5,5,5,5,7,5,7,7,7,7,6
1,13,5,6,11,5,5,5,4,10,2,8,8,10,8,8
1,5,5,14,10,3,5,5,7,14,11,6,3,15,7,4
1,5,5,14,11,13,5,4,8,9,12,9,12,10,10,2
2,1,5,15,14,3,7,5,4,1,7,5,6,10,10,10
11,7,5,12,9,12,9,5,7,5,15,4,8,10,11,14
9,14,3,6,3,6,3,5,12,2,10,3,7,14,10,10
2,11,15,13,14,11,15,7,6,9,13,12,8,11,14,10
11,14,10,2,10,10,10,9,12,3,5,5,7,12,10,10
10,8,10,11,14,10,10,2,3,13,4,1,15,5,14,10
11,6,10,10,8,10,11,14,11,5,5,5,13,7,14,10
11,14,10,9,5,12,10,11,14,1,7,6,1,14,11,14
10,10,10,2,3,4,10,10,9,5,14,9,5,14,10,10
10,10,10,11,13,6,10,10,3,5,15,5,5,12,10,10
10,10,10,10,3,13,14,11,15,5,13,7,5,5,14,10
8,9,12,8,9,4,9,12,9,5,5,13,5,4,9,12
