16
1,6,3,6,3,5,7,5,5,4,3,5,7,5,7,6
3,15,14,11,13,5,13,5,5,6,10,3,14,3,12,10
10,8,10,11,5,5,7,7,5,13,12,8,10,11,6,10
9,6,10,8,1,5,15,13,5,5,6,3,13,14,11,14
3,14,10,3,7,5,13,7,5,5,14,11,4,11,14,10
8,10,10,10,10,3,5,13,6,2,11,14,2,10,10,10
1,14,11,12,9,13,7,4,11,15,14,9,15,12,11,14
3,13,12,3,5,5,12,3,14,10,11,5,13,4,10,8
9,7,5,13,7,7,4,9,12,10,9,4,1,5,14,2
3,12,3,5,14,9,5,5,6,11,7,7,5,5,13,12
11,7,14,2,11,7,7,6,10,8,9,13,7,5,5,4
10,10,10,10,10,11,14,8,10,1,7,7,13,5,5,4
10,10,11,15,15,14,10,2,11,6,10,10,1,5,6,2
10,10,8,10,8,10,11,15,14,11,13,15,7,7,12,10
11,14,1,13,6,10,10,10,11,15,4,8,8,9,6,10
8,9,5,5,12,8,8,9,12,9,4,1,5,5,13,12
