16
1,5,5,7,5,5,5,7,7,5,6,3,6,2,2,2
3,5,5,15,5,5,5,12,9,6,9,12,8,10,10,10
9,5,7,13,5,7,5,5,4,11,5,7,6,10,9,14
1,7,13,5,5,13,7,5,5,12,1,14,10,10,3,12
3,12,2,3,5,7,13,7,5,5,5,14,10,11,14,2
9,7,15,14,2,10,3,15,7,5,5,14,10,10,11,14
3,12,8,10,10,10,10,8,8,1,7,12,10,10,11,14
11,5,4,11,12,9,12,3,6,2,10,2,9,14,10,10
9,6,1,13,7,7,6,11,12,11,14,10,2,11,14,10
3,13,5,7,12,8,11,13,4,10,9,12,11,12,10,10
9,7,4,10,3,6,9,7,6,11,5,4,8,3,12,10
2,11,5,14,10,10,1,14,10,11,6,3,5,12,2,10
11,13,4,9,12,11,7,12,10,10,10,11,6,2,9,14
11,7,5,6,3,14,9,6,11,12,11,12,9,13,7,12
10,8,1,13,12,11,7,12,10,1,15,5,5,5,13,6
9,5,5,5,4,8,9,5,13,5,13,5,5,5,5,12
