16
1,7,7,7,6,3,5,6,2,2,3,5,7,5,5,4
1,12,10,8,10,9,6,10,10,10,10,3,14,2,2,2
2,3,14,1,14,3,13,14,10,10,10,10,11,14,11,14
10,10,10,3,13,13,4,11,14,11,14,8,10,10,8,10
10,10,11,15,7,7,6,11,15,14,9,5,12,11,5,12
11,12,10,10,8,10,8,8,9,15,5,7,5,13,5,6
11,4,8,9,5,14,3,5,5,14,3,13,5,7,5,12
11,7,5,4,2,11,15,7,6,11,13,5,7,13,5,4
10,9,7,4,11,14,8,9,12,11,5,6,11,6,3,6
10,1,15,6,10,9,7,5,6,11,7,13,12,9,12,10
10,3,14,10,10,3,12,2,11,12,10,3,5,4,3,14
10,10,8,11,15,15,5,13,14,3,12,11,5,7,14,10
11,15,5,14,10,11,5,4,11,15,4,9,4,10,10,10
9,15,4,10,10,9,5,6,10,10,2,1,5,14,8,8
2,11,6,8,9,7,5,12,10,11,15,6,3,15,7,4
9,12,9,5,5,13,5,5,12,8,8,9,12,8,9,4
