16
1,6,2,2,2,1,5,7,6,2,1,5,7,5,5,4
3,13,15,13,14,3,5,12,9,13,7,5,13,7,5,4
11,6,11,6,10,9,6,3,6,3,13,5,5,14,3,6
10,10,8,10,11,7,14,10,10,11,4,1,5,13,15,14
10,10,3,14,10,8,9,12,9,15,7,5,5,5,12,10
8,10,10,8,11,7,7,5,5,13,13,5,7,7,4,10
2,10,10,2,10,10,11,5,5,7,6,2,10,11,6,10
11,14,11,15,14,10,10,3,7,14,11,15,15,15,14,10
10,11,12,8,8,8,10,9,12,10,8,10,8,10,9,14
10,11,6,1,5,6,9,5,7,12,2,9,6,10,1,14
10,10,9,5,5,12,3,5,13,5,14,1,14,10,1,14
11,15,5,5,5,4,11,5,5,4,11,7,12,10,1,14
9,15,5,6,1,5,13,7,5,7,14,9,5,13,7,12
3,13,4,11,7,5,6,11,7,14,9,7,5,5,13,4
11,5,4,10,8,1,13,14,8,8,3,13,5,7,5,4
9,5,5,13,5,5,5,13,5,4,9,5,5,13,5,4
