16
1,7,6,3,6,1,5,7,5,5,7,5,5,5,5,6
1,14,9,12,11,7,5,15,5,5,13,7,6,2,3,14
3,13,4,3,14,11,5,13,7,5,4,10,11,14,10,10
11,5,6,10,8,11,5,5,13,7,6,10,10,10,10,10
11,6,10,10,3,13,5,5,5,14,10,10,10,9,12,8
10,10,11,13,15,6,2,2,3,14,10,10,9,5,5,6
10,10,9,4,8,9,15,13,14,11,15,13,5,5,7,12
10,11,6,3,6,2,10,3,14,10,10,2,2,3,14,2
10,10,10,10,10,10,10,9,12,10,10,9,15,12,9,14
10,10,10,10,11,14,10,3,7,14,10,2,9,7,4,10
10,10,11,14,10,9,13,14,8,8,10,11,5,15,4,8
11,14,10,10,10,2,3,13,4,3,13,15,6,10,2,2
10,10,10,10,10,10,11,5,7,13,5,12,11,13,13,12
10,11,15,14,11,15,14,2,11,5,5,4,9,5,7,4
9,13,14,8,10,10,11,12,10,3,6,2,2,3,15,4
1,5,12,1,12,8,9,5,13,12,9,12,9,12,9,4
