16
1,6,2,2,2,1,5,7,4,3,5,5,5,6,2,2
3,14,11,14,10,2,3,12,3,14,1,7,7,13,13,12
10,11,14,11,15,13,13,7,12,10,3,14,11,6,3,4
10,10,10,10,10,3,5,13,4,8,11,15,14,8,11,6
10,8,8,8,9,15,5,5,5,5,14,10,11,7,14,10
9,7,7,7,5,13,5,5,7,5,12,10,8,8,8,10
2,10,10,10,2,3,7,5,13,7,4,10,3,6,3,14
10,10,10,9,13,14,8,3,7,15,6,11,12,9,13,14
10,11,14,3,5,12,2,9,12,10,9,13,5,5,6,10
11,14,11,13,5,5,15,4,3,14,1,7,5,4,10,10
10,10,10,1,7,5,12,2,10,10,3,14,2,3,14,10
11,14,11,5,13,5,5,15,14,11,14,9,13,12,8,10
10,10,11,7,5,5,5,12,10,10,11,5,5,5,7,12
10,10,10,11,5,5,5,4,10,10,11,5,5,5,13,6
10,10,10,11,5,5,5,7,13,14,11,5,7,5,5,12
9,13,13,13,5,5,5,13,4,8,9,5,13,5,5,4
